jour;n_dose1_h;n_complet_h;n_rappel_h;Progression journaliere;Cumul_dose1
2020-12-27;1;0;0;;1
2020-12-27;324;31;0;323.0;325
2020-12-27;24;1;0;-300.0;349
2020-12-27;1;0;0;-23.0;350
2020-12-27;32;3;0;31.0;382
2020-12-27;13;2;0;-19.0;395
2020-12-27;35;2;0;22.0;430
2020-12-27;0;0;0;-35.0;430
2020-12-27;46;10;0;46.0;476
2020-12-27;44;2;0;-2.0;520
2020-12-27;63;5;0;19.0;583
2020-12-27;38;4;0;-25.0;621
2020-12-27;3;0;0;-35.0;624
2020-12-27;0;0;0;-3.0;624
2020-12-27;24;2;0;24.0;648
2020-12-28;354;20;0;330.0;1002
2020-12-28;33;0;0;-321.0;1035
2020-12-28;51;4;0;18.0;1086
2020-12-28;55;1;0;4.0;1141
2020-12-28;2;0;0;-53.0;1143
2020-12-28;25;0;0;23.0;1168
2020-12-28;15;0;0;-10.0;1183
2020-12-28;0;0;0;-15.0;1183
2020-12-28;38;6;0;38.0;1221
2020-12-28;9;0;0;-29.0;1230
2020-12-28;39;4;0;30.0;1269
2020-12-28;39;2;0;0.0;1308
2020-12-28;1;0;0;-38.0;1309
2020-12-28;46;3;0;45.0;1355
2020-12-28;1;0;0;-45.0;1356
2020-12-29;15;1;0;14.0;1371
2020-12-29;17;1;0;2.0;1388
2020-12-29;28;0;0;11.0;1416
2020-12-29;0;0;0;-28.0;1416
2020-12-29;2;0;0;2.0;1418
2020-12-29;23;2;0;21.0;1441
2020-12-29;1;0;0;-22.0;1442
2020-12-29;32;1;0;31.0;1474
2020-12-29;0;0;0;-32.0;1474
2020-12-29;10;0;0;10.0;1484
2020-12-29;19;2;0;9.0;1503
2020-12-29;180;10;0;161.0;1683
2020-12-29;14;2;0;-166.0;1697
2020-12-29;1;0;0;-13.0;1698
2020-12-29;18;1;0;17.0;1716
2020-12-30;207;10;0;189.0;1923
2020-12-30;15;1;0;-192.0;1938
2020-12-30;7;1;0;-8.0;1945
2020-12-30;6;1;0;-1.0;1951
2020-12-30;31;3;0;25.0;1982
2020-12-30;32;0;0;1.0;2014
2020-12-30;27;0;0;-5.0;2041
2020-12-30;0;0;0;-27.0;2041
2020-12-30;28;1;0;28.0;2069
2020-12-30;13;2;0;-15.0;2082
2020-12-30;0;0;0;-13.0;2082
2020-12-30;0;0;0;0.0;2082
2020-12-30;0;0;0;0.0;2082
2020-12-30;27;1;0;27.0;2109
2020-12-30;21;0;0;-6.0;2130
2020-12-31;24;0;0;3.0;2154
2020-12-31;13;0;0;-11.0;2167
2020-12-31;26;3;0;13.0;2193
2020-12-31;208;10;0;182.0;2401
2020-12-31;10;0;0;-198.0;2411
2020-12-31;20;0;0;10.0;2431
2020-12-31;5;0;0;-15.0;2436
2020-12-31;10;1;0;5.0;2446
2020-12-31;16;0;0;6.0;2462
2020-12-31;0;0;0;-16.0;2462
2020-12-31;0;0;0;0.0;2462
2020-12-31;23;2;0;23.0;2485
2020-12-31;37;2;0;14.0;2522
2020-12-31;23;2;0;-14.0;2545
2020-12-31;1;0;0;-22.0;2546
2021-01-01;33;3;0;32.0;2579
2021-01-01;89;3;0;56.0;2668
2021-01-01;95;6;0;6.0;2763
2021-01-01;19;0;0;-76.0;2782
2021-01-01;20;0;0;1.0;2802
2021-01-01;43;5;0;23.0;2845
2021-01-01;0;0;0;-43.0;2845
2021-01-01;78;3;0;78.0;2923
2021-01-01;145;13;0;67.0;3068
2021-01-01;2;0;0;-143.0;3070
2021-01-01;1;0;0;-1.0;3071
2021-01-01;674;40;0;673.0;3745
2021-01-01;23;2;0;-651.0;3768
2021-01-01;36;3;0;13.0;3804
2021-01-01;90;2;0;54.0;3894
2021-01-02;9;1;0;-81.0;3903
2021-01-02;0;0;0;-9.0;3903
2021-01-02;0;0;0;0.0;3903
2021-01-02;0;0;0;0.0;3903
2021-01-02;14;0;0;14.0;3917
2021-01-02;42;1;0;28.0;3959
2021-01-02;1;0;0;-41.0;3960
2021-01-02;9;1;0;8.0;3969
2021-01-02;12;2;0;3.0;3981
2021-01-02;186;15;0;174.0;4167
2021-01-02;15;2;0;-171.0;4182
2021-01-02;24;1;0;9.0;4206
2021-01-02;28;3;0;4.0;4234
2021-01-02;11;2;0;-17.0;4245
2021-01-02;21;2;0;10.0;4266
2021-01-03;44;2;0;23.0;4310
2021-01-03;31;0;0;-13.0;4341
2021-01-03;3;0;0;-28.0;4344
2021-01-03;3;0;0;0.0;4347
2021-01-03;28;2;0;25.0;4375
2021-01-03;24;3;0;-4.0;4399
2021-01-03;20;1;0;-4.0;4419
2021-01-03;0;0;0;-20.0;4419
2021-01-03;11;0;0;11.0;4430
2021-01-03;9;0;0;-2.0;4439
2021-01-03;0;0;0;-9.0;4439
2021-01-03;16;1;0;16.0;4455
2021-01-03;213;10;0;197.0;4668
2021-01-03;0;0;0;-213.0;4668
2021-01-03;24;1;0;24.0;4692
2021-01-04;3;0;0;-21.0;4695
2021-01-04;44;2;0;41.0;4739
2021-01-04;0;0;0;-44.0;4739
2021-01-04;1015;25;0;1015.0;5754
2021-01-04;47;1;0;-968.0;5801
2021-01-04;103;1;0;56.0;5904
2021-01-04;1;0;0;-102.0;5905
2021-01-04;93;3;0;92.0;5998
2021-01-04;87;5;0;-6.0;6085
2021-01-04;7;0;0;-80.0;6092
2021-01-04;264;5;0;257.0;6356
2021-01-04;49;1;0;-215.0;6405
2021-01-04;139;4;0;90.0;6544
2021-01-04;85;1;0;-54.0;6629
2021-01-04;93;2;0;8.0;6722
2021-01-05;74;2;0;-19.0;6796
2021-01-05;207;7;0;133.0;7003
2021-01-05;275;5;0;68.0;7278
2021-01-05;396;10;0;121.0;7674
2021-01-05;938;9;0;542.0;8612
2021-01-05;135;4;0;-803.0;8747
2021-01-05;503;5;0;368.0;9250
2021-01-05;216;2;0;-287.0;9466
2021-01-05;6;0;0;-210.0;9472
2021-01-05;5;0;0;-1.0;9477
2021-01-05;3649;63;0;3644.0;13126
2021-01-05;218;4;0;-3431.0;13344
2021-01-05;315;4;0;97.0;13659
2021-01-05;13;0;0;-302.0;13672
2021-01-05;348;11;0;335.0;14020
2021-01-06;401;9;0;53.0;14421
2021-01-06;3;0;0;-398.0;14424
2021-01-06;1873;9;0;1870.0;16297
2021-01-06;105;4;0;-1768.0;16402
2021-01-06;21;0;0;-84.0;16423
2021-01-06;5396;52;0;5375.0;21819
2021-01-06;2;0;0;-5394.0;21821
2021-01-06;468;5;0;466.0;22289
2021-01-06;313;4;0;-155.0;22602
2021-01-06;566;2;0;253.0;23168
2021-01-06;129;1;0;-437.0;23297
2021-01-06;404;10;0;275.0;23701
2021-01-06;195;3;0;-209.0;23896
2021-01-06;916;5;0;721.0;24812
2021-01-06;0;0;0;-916.0;24812
2021-01-07;169;2;0;169.0;24981
2021-01-07;992;4;0;823.0;25973
2021-01-07;1944;12;0;952.0;27917
2021-01-07;489;3;0;-1455.0;28406
2021-01-07;479;7;0;-10.0;28885
2021-01-07;1;1;0;-478.0;28886
2021-01-07;3745;10;0;3744.0;32631
2021-01-07;97;3;0;-3648.0;32728
2021-01-07;1254;7;0;1157.0;33982
2021-01-07;1;0;0;-1253.0;33983
2021-01-07;1593;5;0;1592.0;35576
2021-01-07;9;1;0;-1584.0;35585
2021-01-07;11565;66;0;11556.0;47150
2021-01-07;1;0;0;-11564.0;47151
2021-01-07;791;11;0;790.0;47942
2021-01-08;1;0;0;-790.0;47943
2021-01-08;2;0;0;1.0;47945
2021-01-08;0;0;0;-2.0;47945
2021-01-08;1622;6;0;1622.0;49567
2021-01-08;13;0;0;-1609.0;49580
2021-01-08;1558;6;0;1545.0;51138
2021-01-08;1131;6;0;-427.0;52269
2021-01-08;1183;3;0;52.0;53452
2021-01-08;600;5;0;-583.0;54052
2021-01-08;724;5;0;124.0;54776
2021-01-08;116;0;0;-608.0;54892
2021-01-08;2436;15;0;2320.0;57328
2021-01-08;5017;23;0;2581.0;62345
2021-01-08;238;6;0;-4779.0;62583
2021-01-08;14641;75;0;14403.0;77224
2021-01-09;521;5;0;-14120.0;77745
2021-01-09;20;1;0;-501.0;77765
2021-01-09;3;0;0;-17.0;77768
2021-01-09;0;0;0;-3.0;77768
2021-01-09;1735;5;0;1735.0;79503
2021-01-09;0;0;0;-1735.0;79503
2021-01-09;5281;30;0;5281.0;84784
2021-01-09;44;1;0;-5237.0;84828
2021-01-09;0;0;0;-44.0;84828
2021-01-09;1037;2;0;1037.0;85865
2021-01-09;204;2;0;-833.0;86069
2021-01-09;349;5;0;145.0;86418
2021-01-09;229;2;0;-120.0;86647
2021-01-09;732;4;0;503.0;87379
2021-01-09;407;3;0;-325.0;87786
2021-01-10;1;0;0;-406.0;87787
2021-01-10;139;1;0;138.0;87926
2021-01-10;828;3;0;689.0;88754
2021-01-10;530;1;0;-298.0;89284
2021-01-10;39;0;0;-491.0;89323
2021-01-10;129;1;0;90.0;89452
2021-01-10;336;2;0;207.0;89788
2021-01-10;11;0;0;-325.0;89799
2021-01-10;130;0;0;119.0;89929
2021-01-10;49;0;0;-81.0;89978
2021-01-10;0;0;0;-49.0;89978
2021-01-10;0;0;0;0.0;89978
2021-01-10;220;1;0;220.0;90198
2021-01-10;400;1;0;180.0;90598
2021-01-10;2812;10;0;2412.0;93410
2021-01-11;2;0;0;-2810.0;93412
2021-01-11;683;10;0;681.0;94095
2021-01-11;15112;95;0;14429.0;109207
2021-01-11;119;2;0;-14993.0;109326
2021-01-11;7;0;0;-112.0;109333
2021-01-11;1348;10;0;1341.0;110681
2021-01-11;2;0;0;-1346.0;110683
2021-01-11;5095;26;0;5093.0;115778
2021-01-11;1409;10;0;-3686.0;117187
2021-01-11;1;0;0;-1408.0;117188
2021-01-11;1671;8;0;1670.0;118859
2021-01-11;1316;12;0;-355.0;120175
2021-01-11;2407;8;0;1091.0;122582
2021-01-11;788;7;0;-1619.0;123370
2021-01-11;264;2;0;-524.0;123634
2021-01-12;1133;3;0;869.0;124767
2021-01-12;3383;15;0;2250.0;128150
2021-01-12;378;10;0;-3005.0;128528
2021-01-12;1191;13;0;813.0;129719
2021-01-12;8;1;0;-1183.0;129727
2021-01-12;22324;109;0;22316.0;152051
2021-01-12;157;6;0;-22167.0;152208
2021-01-12;2;0;0;-155.0;152210
2021-01-12;1912;8;0;1910.0;154122
2021-01-12;0;0;0;-1912.0;154122
2021-01-12;0;0;0;0.0;154122
2021-01-12;1840;9;0;1840.0;155962
2021-01-12;6802;25;0;4962.0;162764
2021-01-12;2310;5;0;-4492.0;165074
2021-01-12;3208;14;0;898.0;168282
2021-01-13;7242;41;0;4034.0;175524
2021-01-13;2212;14;0;-5030.0;177736
2021-01-13;192;2;0;-2020.0;177928
2021-01-13;1906;16;0;1714.0;179834
2021-01-13;3;0;0;-1903.0;179837
2021-01-13;1364;13;0;1361.0;181201
2021-01-13;3277;18;0;1913.0;184478
2021-01-13;2146;17;0;-1131.0;186624
2021-01-13;504;9;0;-1642.0;187128
2021-01-13;3270;17;0;2766.0;190398
2021-01-13;1;0;0;-3269.0;190399
2021-01-13;3;0;0;2.0;190402
2021-01-13;23605;155;0;23602.0;214007
2021-01-13;1470;7;0;-22135.0;215477
2021-01-13;15;1;0;-1455.0;215492
2021-01-14;1668;40;0;1653.0;217160
2021-01-14;642;19;0;-1026.0;217802
2021-01-14;0;0;0;-642.0;217802
2021-01-14;0;0;0;0.0;217802
2021-01-14;2645;47;0;2645.0;220447
2021-01-14;29318;443;0;26673.0;249765
2021-01-14;3803;53;0;-25515.0;253568
2021-01-14;2607;38;0;-1196.0;256175
2021-01-14;2381;39;0;-226.0;258556
2021-01-14;234;8;0;-2147.0;258790
2021-01-14;13;0;0;-221.0;258803
2021-01-14;2441;42;0;2428.0;261244
2021-01-14;5;1;0;-2436.0;261249
2021-01-14;5034;57;0;5029.0;266283
2021-01-14;7842;99;0;2808.0;274125
2021-01-15;2852;30;0;-4990.0;276977
2021-01-15;4133;25;0;1281.0;281110
2021-01-15;2810;16;0;-1323.0;283920
2021-01-15;24830;182;0;22020.0;308750
2021-01-15;195;4;0;-24635.0;308945
2021-01-15;0;0;0;-195.0;308945
2021-01-15;1;0;0;1.0;308946
2021-01-15;1474;13;0;1473.0;310420
2021-01-15;5;0;0;-1469.0;310425
2021-01-15;458;6;0;453.0;310883
2021-01-15;11;1;0;-447.0;310894
2021-01-15;2043;16;0;2032.0;312937
2021-01-15;2106;12;0;63.0;315043
2021-01-15;2345;21;0;239.0;317388
2021-01-15;6397;38;0;4052.0;323785
2021-01-16;94;1;0;-6303.0;323879
2021-01-16;8740;84;0;8646.0;332619
2021-01-16;3;0;0;-8737.0;332622
2021-01-16;716;9;0;713.0;333338
2021-01-16;559;7;0;-157.0;333897
2021-01-16;983;9;0;424.0;334880
2021-01-16;283;3;0;-700.0;335163
2021-01-16;1808;12;0;1525.0;336971
2021-01-16;709;6;0;-1099.0;337680
2021-01-16;47;3;0;-662.0;337727
2021-01-16;0;0;0;-47.0;337727
2021-01-16;1504;14;0;1504.0;339231
2021-01-16;2;0;0;-1502.0;339233
2021-01-16;1;0;0;-1.0;339234
2021-01-16;2031;20;0;2030.0;341265
2021-01-17;686;6;0;-1345.0;341951
2021-01-17;421;7;0;-265.0;342372
2021-01-17;166;4;0;-255.0;342538
2021-01-17;0;0;0;-166.0;342538
2021-01-17;4030;60;0;4030.0;346568
2021-01-17;372;9;0;-3658.0;346940
2021-01-17;0;0;0;-372.0;346940
2021-01-17;599;9;0;599.0;347539
2021-01-17;1128;9;0;529.0;348667
2021-01-17;338;10;0;-790.0;349005
2021-01-17;1;0;0;-337.0;349006
2021-01-17;2;0;0;1.0;349008
2021-01-17;41;0;0;39.0;349049
2021-01-17;225;4;0;184.0;349274
2021-01-17;51;2;0;-174.0;349325
2021-01-18;1795;14;0;1744.0;351120
2021-01-18;0;0;0;-1795.0;351120
2021-01-18;2476;16;0;2476.0;353596
2021-01-18;3972;45;0;1496.0;357568
2021-01-18;1734;14;0;-2238.0;359302
2021-01-18;0;0;0;-1734.0;359302
2021-01-18;182;4;0;182.0;359484
2021-01-18;8;1;0;-174.0;359492
2021-01-18;34937;229;0;34929.0;394429
2021-01-18;1026;20;0;-33911.0;395455
2021-01-18;11561;42;0;10535.0;407016
2021-01-18;368;17;0;-11193.0;407384
2021-01-18;10248;36;0;9880.0;417632
2021-01-18;1564;20;0;-8684.0;419196
2021-01-18;3;0;0;-1561.0;419199
2021-01-19;3568;35;0;3565.0;422767
2021-01-19;2707;21;0;-861.0;425474
2021-01-19;13315;39;0;10608.0;438789
2021-01-19;1964;21;0;-11351.0;440753
2021-01-19;18637;88;0;16673.0;459390
2021-01-19;1;0;0;-18636.0;459391
2021-01-19;50003;326;0;50002.0;509394
2021-01-19;2595;22;0;-47408.0;511989
2021-01-19;0;0;0;-2595.0;511989
2021-01-19;435;11;0;435.0;512424
2021-01-19;1;0;0;-434.0;512425
2021-01-19;1195;18;0;1194.0;513620
2021-01-19;13;1;0;-1182.0;513633
2021-01-19;223;6;0;210.0;513856
2021-01-19;5349;64;0;5126.0;519205
2021-01-20;1402;18;0;-3947.0;520607
2021-01-20;2049;19;0;647.0;522656
2021-01-20;0;0;0;-2049.0;522656
2021-01-20;20705;95;0;20705.0;543361
2021-01-20;2625;28;0;-18080.0;545986
2021-01-20;200;2;0;-2425.0;546186
2021-01-20;2682;29;0;2482.0;548868
2021-01-20;53298;294;0;50616.0;602166
2021-01-20;8;1;0;-53290.0;602174
2021-01-20;3739;14;0;3731.0;605913
2021-01-20;14207;36;0;10468.0;620120
2021-01-20;5265;44;0;-8942.0;625385
2021-01-20;413;8;0;-4852.0;625798
2021-01-20;3;0;0;-410.0;625801
2021-01-20;0;0;0;-3.0;625801
2021-01-21;1;0;0;1.0;625802
2021-01-21;293;6;0;292.0;626095
2021-01-21;59367;356;0;59074.0;685462
2021-01-21;16;0;0;-59351.0;685478
2021-01-21;2;1;0;-14.0;685480
2021-01-21;537;9;0;535.0;686017
2021-01-21;1627;16;0;1090.0;687644
2021-01-21;3115;38;0;1488.0;690759
2021-01-21;2534;36;0;-581.0;693293
2021-01-21;2;0;0;-2532.0;693295
2021-01-21;15126;41;0;15124.0;708421
2021-01-21;23108;84;0;7982.0;731529
2021-01-21;4360;35;0;-18748.0;735889
2021-01-21;2989;27;0;-1371.0;738878
2021-01-21;5657;63;0;2668.0;744535
2021-01-22;238;6;0;-5419.0;744773
2021-01-22;0;0;0;-238.0;744773
2021-01-22;14007;45;0;14007.0;758780
2021-01-22;49325;310;0;35318.0;808105
2021-01-22;8;0;0;-49317.0;808113
2021-01-22;1;0;0;-7.0;808114
2021-01-22;2;0;0;1.0;808116
2021-01-22;456;10;0;454.0;808572
2021-01-22;18750;62;0;18294.0;827322
2021-01-22;1337;29;0;-17413.0;828659
2021-01-22;2434;27;0;1097.0;831093
2021-01-22;4439;56;0;2005.0;835532
2021-01-22;3391;29;0;-1048.0;838923
2021-01-22;1938;14;0;-1453.0;840861
2021-01-22;2324;32;0;386.0;843185
2021-01-23;440;6;0;-1884.0;843625
2021-01-23;761;10;0;321.0;844386
2021-01-23;1;0;0;-760.0;844387
2021-01-23;0;0;0;-1.0;844387
2021-01-23;6760;21;0;6760.0;851147
2021-01-23;6;0;0;-6754.0;851153
2021-01-23;254;3;0;248.0;851407
2021-01-23;1201;17;0;947.0;852608
2021-01-23;5719;17;0;4518.0;858327
2021-01-23;1;0;0;-5718.0;858328
2021-01-23;1155;8;0;1154.0;859483
2021-01-23;710;12;0;-445.0;860193
2021-01-23;60;2;0;-650.0;860253
2021-01-23;17153;98;0;17093.0;877406
2021-01-23;82;2;0;-17071.0;877488
2021-01-24;285;16;0;203.0;877773
2021-01-24;6;0;0;-279.0;877779
2021-01-24;0;0;0;-6.0;877779
2021-01-24;338;21;0;338.0;878117
2021-01-24;1;0;0;-337.0;878118
2021-01-24;0;0;0;-1.0;878118
2021-01-24;259;11;0;259.0;878377
2021-01-24;122;3;0;-137.0;878499
2021-01-24;1522;7;0;1400.0;880021
2021-01-24;1044;9;0;-478.0;881065
2021-01-24;3919;98;0;2875.0;884984
2021-01-24;211;17;0;-3708.0;885195
2021-01-24;29;2;0;-182.0;885224
2021-01-24;23;2;0;-6.0;885247
2021-01-24;79;10;0;56.0;885326
2021-01-25;2106;273;0;2027.0;887432
2021-01-25;3;0;0;-2103.0;887435
2021-01-25;213;11;0;210.0;887648
2021-01-25;573;27;0;360.0;888221
2021-01-25;0;0;0;-573.0;888221
2021-01-25;878;52;0;878.0;889099
2021-01-25;33948;770;0;33070.0;923047
2021-01-25;3;0;0;-33945.0;923050
2021-01-25;13469;70;0;13466.0;936519
2021-01-25;16;0;0;-13453.0;936535
2021-01-25;1253;145;0;1237.0;937788
2021-01-25;11291;55;0;10038.0;949079
2021-01-25;1562;81;0;-9729.0;950641
2021-01-25;163;3;0;-1399.0;950804
2021-01-25;2418;53;0;2255.0;953222
2021-01-26;14;0;0;-2404.0;953236
2021-01-26;230;14;0;216.0;953466
2021-01-26;1909;173;0;1679.0;955375
2021-01-26;2655;585;0;746.0;958030
2021-01-26;41328;1703;0;38673.0;999358
2021-01-26;17170;219;0;-24158.0;1016528
2021-01-26;0;0;0;-17170.0;1016528
2021-01-26;4;0;0;4.0;1016532
2021-01-26;2933;138;0;2929.0;1019465
2021-01-26;725;42;0;-2208.0;1020190
2021-01-26;0;0;0;-725.0;1020190
2021-01-26;134;7;0;134.0;1020324
2021-01-26;1505;333;0;1371.0;1021829
2021-01-26;12842;101;0;11337.0;1034671
2021-01-26;1207;91;0;-11635.0;1035878
2021-01-27;251;35;0;-956.0;1036129
2021-01-27;42382;2897;0;42131.0;1078511
2021-01-27;2829;996;0;-39553.0;1081340
2021-01-27;3074;218;0;245.0;1084414
2021-01-27;152;7;0;-2922.0;1084566
2021-01-27;1628;499;0;1476.0;1086194
2021-01-27;1253;151;0;-375.0;1087447
2021-01-27;2048;350;0;795.0;1089495
2021-01-27;18125;378;0;16077.0;1107620
2021-01-27;771;107;0;-17354.0;1108391
2021-01-27;0;0;0;-771.0;1108391
2021-01-27;5;1;0;5.0;1108396
2021-01-27;1;0;0;-4.0;1108397
2021-01-27;16;0;0;15.0;1108413
2021-01-27;12229;155;0;12213.0;1120642
2021-01-28;20187;1188;0;7958.0;1140829
2021-01-28;1683;392;0;-18504.0;1142512
2021-01-28;3;0;0;-1680.0;1142515
2021-01-28;0;0;0;-3.0;1142515
2021-01-28;1;0;0;1.0;1142516
2021-01-28;3212;1907;0;3211.0;1145728
2021-01-28;46746;6475;0;43534.0;1192474
2021-01-28;12115;361;0;-34631.0;1204589
2021-01-28;2327;682;0;-9788.0;1206916
2021-01-28;1110;199;0;-1217.0;1208026
2021-01-28;1999;1057;0;889.0;1210025
2021-01-28;352;60;0;-1647.0;1210377
2021-01-28;3568;609;0;3216.0;1213945
2021-01-28;12;1;0;-3556.0;1213957
2021-01-28;177;19;0;165.0;1214134
2021-01-29;2937;690;0;2760.0;1217071
2021-01-29;10965;356;0;8028.0;1228036
2021-01-29;4;0;0;-10961.0;1228040
2021-01-29;1;0;0;-3.0;1228041
2021-01-29;855;293;0;854.0;1228896
2021-01-29;1547;1324;0;692.0;1230443
2021-01-29;15;3;0;-1532.0;1230458
2021-01-29;14927;1037;0;14912.0;1245385
2021-01-29;0;0;0;-14927.0;1245385
2021-01-29;37608;7795;0;37608.0;1282993
2021-01-29;272;68;0;-37336.0;1283265
2021-01-29;160;35;0;-112.0;1283425
2021-01-29;1416;585;0;1256.0;1284841
2021-01-29;2579;2533;0;1163.0;1287420
2021-01-29;1930;871;0;-649.0;1289350
2021-01-30;49;6;0;-1881.0;1289399
2021-01-30;12929;2095;0;12880.0;1302328
2021-01-30;0;0;0;-12929.0;1302328
2021-01-30;307;145;0;307.0;1302635
2021-01-30;180;86;0;-127.0;1302815
2021-01-30;4169;107;0;3989.0;1306984
2021-01-30;555;284;0;-3614.0;1307539
2021-01-30;758;652;0;203.0;1308297
2021-01-30;0;0;0;-758.0;1308297
2021-01-30;5550;192;0;5550.0;1313847
2021-01-30;6;2;0;-5544.0;1313853
2021-01-30;1;1;0;-5.0;1313854
2021-01-30;878;194;0;877.0;1314732
2021-01-30;61;16;0;-817.0;1314793
2021-01-30;415;410;0;354.0;1315208
2021-01-31;99;120;0;-316.0;1315307
2021-01-31;0;0;0;-99.0;1315307
2021-01-31;0;0;0;0.0;1315307
2021-01-31;83;172;0;83.0;1315390
2021-01-31;2;0;0;-81.0;1315392
2021-01-31;0;0;0;-2.0;1315392
2021-01-31;58;24;0;58.0;1315450
2021-01-31;145;226;0;87.0;1315595
2021-01-31;560;43;0;415.0;1316155
2021-01-31;27;17;0;-533.0;1316182
2021-01-31;168;108;0;141.0;1316350
2021-01-31;63;47;0;-105.0;1316413
2021-01-31;25;7;0;-38.0;1316438
2021-01-31;871;74;0;846.0;1317309
2021-01-31;2101;838;0;1230.0;1319410
2021-02-01;375;379;0;-1726.0;1319785
2021-02-01;541;723;0;166.0;1320326
2021-02-01;762;1505;0;221.0;1321088
2021-02-01;9565;872;0;8803.0;1330653
2021-02-01;0;0;0;-9565.0;1330653
2021-02-01;7965;478;0;7965.0;1338618
2021-02-01;999;1110;0;-6966.0;1339617
2021-02-01;1105;3025;0;106.0;1340722
2021-02-01;0;0;0;-1105.0;1340722
2021-02-01;170;52;0;170.0;1340892
2021-02-01;25;2;0;-145.0;1340917
2021-02-01;0;0;0;-25.0;1340917
2021-02-01;1761;810;0;1761.0;1342678
2021-02-01;178;108;0;-1583.0;1342856
2021-02-01;23447;9064;0;23269.0;1366303
2021-02-02;1535;4149;0;-21912.0;1367838
2021-02-02;1383;1474;0;-152.0;1369221
2021-02-02;126;59;0;-1257.0;1369347
2021-02-02;754;1045;0;628.0;1370101
2021-02-02;2306;1266;0;1552.0;1372407
2021-02-02;166;150;0;-2140.0;1372573
2021-02-02;9427;791;0;9261.0;1382000
2021-02-02;30338;13883;0;20911.0;1412338
2021-02-02;1024;2092;0;-29314.0;1413362
2021-02-02;500;566;0;-524.0;1413862
2021-02-02;2;0;0;-498.0;1413864
2021-02-02;18;1;0;16.0;1413882
2021-02-02;0;0;0;-18.0;1413882
2021-02-02;1;0;0;1.0;1413883
2021-02-02;13096;2290;0;13095.0;1426979
2021-02-03;0;0;0;-13096.0;1426979
2021-02-03;1099;2098;0;1099.0;1428078
2021-02-03;103;65;0;-996.0;1428181
2021-02-03;2;0;0;-101.0;1428183
2021-02-03;12707;2293;0;12705.0;1440890
2021-02-03;8913;980;0;-3794.0;1449803
2021-02-03;1397;1548;0;-7516.0;1451200
2021-02-03;749;1199;0;-648.0;1451949
2021-02-03;2353;1255;0;1604.0;1454302
2021-02-03;155;186;0;-2198.0;1454457
2021-02-03;12;2;0;-143.0;1454469
2021-02-03;492;645;0;480.0;1454961
2021-02-03;1;0;0;-491.0;1454962
2021-02-03;1576;4611;0;1575.0;1456538
2021-02-03;29559;14882;0;27983.0;1486097
2021-02-04;32414;19408;0;2855.0;1518511
2021-02-04;2649;1713;0;-29765.0;1521160
2021-02-04;2;1;0;-2647.0;1521162
2021-02-04;240;247;0;238.0;1521402
2021-02-04;1660;1984;0;1420.0;1523062
2021-02-04;14;3;0;-1646.0;1523076
2021-02-04;1862;5219;0;1848.0;1524938
2021-02-04;2;0;0;-1860.0;1524940
2021-02-04;1;0;0;-1.0;1524941
2021-02-04;632;821;0;631.0;1525573
2021-02-04;1253;2736;0;621.0;1526826
2021-02-04;13691;3683;0;12438.0;1540517
2021-02-04;9177;1408;0;-4514.0;1549694
2021-02-04;154;102;0;-9023.0;1549848
2021-02-04;1077;1491;0;923.0;1550925
2021-02-05;1382;1659;0;305.0;1552307
2021-02-05;8719;1507;0;7337.0;1561026
2021-02-05;194;276;0;-8525.0;1561220
2021-02-05;11915;2928;0;11721.0;1573135
2021-02-05;2380;1446;0;-9535.0;1575515
2021-02-05;28768;17443;0;26388.0;1604283
2021-02-05;7;1;0;-28761.0;1604290
2021-02-05;121;108;0;114.0;1604411
2021-02-05;523;891;0;402.0;1604934
2021-02-05;1027;2323;0;504.0;1605961
2021-02-05;1;0;0;-1026.0;1605962
2021-02-05;1635;4711;0;1634.0;1607597
2021-02-05;0;0;0;-1635.0;1607597
2021-02-05;862;1593;0;862.0;1608459
2021-02-05;2;0;0;-860.0;1608461
2021-02-06;457;566;0;455.0;1608918
2021-02-06;4201;806;0;3744.0;1613119
2021-02-06;0;0;0;-4201.0;1613119
2021-02-06;7;1;0;7.0;1613126
2021-02-06;3168;587;0;3161.0;1616294
2021-02-06;68;36;0;-3100.0;1616362
2021-02-06;380;725;0;312.0;1616742
2021-02-06;2;0;0;-378.0;1616744
2021-02-06;265;298;0;263.0;1617009
2021-02-06;824;526;0;559.0;1617833
2021-02-06;10179;4872;0;9355.0;1628012
2021-02-06;54;22;0;-10125.0;1628066
2021-02-06;1;0;0;-53.0;1628067
2021-02-06;537;1151;0;536.0;1628604
2021-02-06;215;154;0;-322.0;1628819
2021-02-07;0;0;0;-215.0;1628819
2021-02-07;90;287;0;90.0;1628909
2021-02-07;569;546;0;479.0;1629478
2021-02-07;68;7;0;-501.0;1629546
2021-02-07;147;429;0;79.0;1629693
2021-02-07;0;0;0;-147.0;1629693
2021-02-07;99;308;0;99.0;1629792
2021-02-07;416;240;0;317.0;1630208
2021-02-07;3;0;0;-413.0;1630211
2021-02-07;121;25;0;118.0;1630332
2021-02-07;0;0;0;-121.0;1630332
2021-02-07;175;117;0;175.0;1630507
2021-02-07;137;291;0;-38.0;1630644
2021-02-07;2002;2328;0;1865.0;1632646
2021-02-07;177;78;0;-1825.0;1632823
2021-02-08;970;3807;0;793.0;1633793
2021-02-08;15;3;0;-955.0;1633808
2021-02-08;1;0;0;-14.0;1633809
2021-02-08;0;0;0;-1.0;1633809
2021-02-08;6423;3190;0;6423.0;1640232
2021-02-08;20471;18405;0;14048.0;1660703
2021-02-08;1611;1603;0;-18860.0;1662314
2021-02-08;613;1229;0;-998.0;1662927
2021-02-08;245;305;0;-368.0;1663172
2021-02-08;0;0;0;-245.0;1663172
2021-02-08;8254;4079;0;8254.0;1671426
2021-02-08;926;1461;0;-7328.0;1672352
2021-02-08;692;1802;0;-234.0;1673044
2021-02-08;165;130;0;-527.0;1673209
2021-02-08;556;796;0;391.0;1673765
2021-02-09;7514;4143;0;6958.0;1681279
2021-02-09;2;0;0;-7512.0;1681281
2021-02-09;1238;1715;0;1236.0;1682519
2021-02-09;1073;2615;0;-165.0;1683592
2021-02-09;27163;27299;0;26090.0;1710755
2021-02-09;0;0;0;-27163.0;1710755
2021-02-09;8;2;0;8.0;1710763
2021-02-09;473;364;0;465.0;1711236
2021-02-09;1;0;0;-472.0;1711237
2021-02-09;10483;7891;0;10482.0;1721720
2021-02-09;286;141;0;-10197.0;1722006
2021-02-09;998;1152;0;712.0;1723004
2021-02-09;1584;4954;0;586.0;1724588
2021-02-09;1315;2084;0;-269.0;1725903
2021-02-09;2188;2238;0;873.0;1728091
2021-02-10;10451;8875;0;8263.0;1738542
2021-02-10;633;438;0;-9818.0;1739175
2021-02-10;1642;1963;0;1009.0;1740817
2021-02-10;7411;4303;0;5769.0;1748228
2021-02-10;1376;1277;0;-6035.0;1749604
2021-02-10;1410;2158;0;34.0;1751014
2021-02-10;2423;2311;0;1013.0;1753437
2021-02-10;1193;2621;0;-1230.0;1754630
2021-02-10;1850;5056;0;657.0;1756480
2021-02-10;28805;29216;0;26955.0;1785285
2021-02-10;391;208;0;-28414.0;1785676
2021-02-10;1;0;0;-390.0;1785677
2021-02-10;1;0;0;0.0;1785678
2021-02-10;23;6;0;22.0;1785701
2021-02-10;0;0;0;-23.0;1785701
2021-02-11;2932;2831;0;2932.0;1788633
2021-02-11;1931;1504;0;-1001.0;1790564
2021-02-11;1;0;0;-1930.0;1790565
2021-02-11;34161;35334;0;34160.0;1824726
2021-02-11;2275;2402;0;-31886.0;1827001
2021-02-11;2;0;0;-2273.0;1827003
2021-02-11;861;534;0;859.0;1827864
2021-02-11;7815;4970;0;6954.0;1835679
2021-02-11;2418;5888;0;-5397.0;1838097
2021-02-11;1924;2604;0;-494.0;1840021
2021-02-11;1544;3106;0;-380.0;1841565
2021-02-11;506;218;0;-1038.0;1842071
2021-02-11;12;3;0;-494.0;1842083
2021-02-11;11938;11274;0;11926.0;1854021
2021-02-11;2;0;0;-11936.0;1854023
2021-02-12;2243;4832;0;2241.0;1856266
2021-02-12;7480;4958;0;5237.0;1863746
2021-02-12;0;0;0;-7480.0;1863746
2021-02-12;1701;1894;0;1701.0;1865447
2021-02-12;2801;2130;0;1100.0;1868248
2021-02-12;2;0;0;-2799.0;1868250
2021-02-12;787;428;0;785.0;1869037
2021-02-12;0;0;0;-787.0;1869037
2021-02-12;553;192;0;553.0;1869590
2021-02-12;1822;1327;0;1269.0;1871412
2021-02-12;10793;8139;0;8971.0;1882205
2021-02-12;1425;2199;0;-9368.0;1883630
2021-02-12;2036;1864;0;611.0;1885666
2021-02-12;31658;27967;0;29622.0;1917324
2021-02-12;15;4;0;-31643.0;1917339
2021-02-13;490;524;0;475.0;1917829
2021-02-13;2382;2273;0;1892.0;1920211
2021-02-13;617;1162;0;-1765.0;1920828
2021-02-13;404;634;0;-213.0;1921232
2021-02-13;1;0;0;-403.0;1921233
2021-02-13;0;1;0;-1.0;1921233
2021-02-13;123;37;0;123.0;1921356
2021-02-13;163;61;0;40.0;1921519
2021-02-13;421;214;0;258.0;1921940
2021-02-13;11;1;0;-410.0;1921951
2021-02-13;1;0;0;-10.0;1921952
2021-02-13;906;632;0;905.0;1922858
2021-02-13;3386;2525;0;2480.0;1926244
2021-02-13;9493;8467;0;6107.0;1935737
2021-02-13;588;403;0;-8905.0;1936325
2021-02-14;628;906;0;40.0;1936953
2021-02-14;153;241;0;-475.0;1937106
2021-02-14;36;12;0;-117.0;1937142
2021-02-14;141;303;0;105.0;1937283
2021-02-14;0;0;0;-141.0;1937283
2021-02-14;0;0;0;0.0;1937283
2021-02-14;162;88;0;162.0;1937445
2021-02-14;207;261;0;45.0;1937652
2021-02-14;68;31;0;-139.0;1937720
2021-02-14;95;199;0;27.0;1937815
2021-02-14;2092;2717;0;1997.0;1939907
2021-02-14;170;126;0;-1922.0;1940077
2021-02-14;429;549;0;259.0;1940506
2021-02-14;3;1;0;-426.0;1940509
2021-02-14;0;0;0;-3.0;1940509
2021-02-15;2;0;0;2.0;1940511
2021-02-15;3401;10562;0;3399.0;1943912
2021-02-15;571;310;0;-2830.0;1944483
2021-02-15;1190;1178;0;619.0;1945673
2021-02-15;0;0;0;-1190.0;1945673
2021-02-15;353;132;0;353.0;1946026
2021-02-15;15450;32890;0;15097.0;1961476
2021-02-15;1128;819;0;-14322.0;1962604
2021-02-15;4740;11600;0;3612.0;1967344
2021-02-15;1177;3101;0;-3563.0;1968521
2021-02-15;818;1465;0;-359.0;1969339
2021-02-15;11;5;0;-807.0;1969350
2021-02-15;0;0;0;-11.0;1969350
2021-02-15;1345;2239;0;1345.0;1970695
2021-02-15;714;1479;0;-631.0;1971409
2021-02-16;772;430;0;58.0;1972181
2021-02-16;1744;4035;0;972.0;1973925
2021-02-16;1737;2777;0;-7.0;1975662
2021-02-16;1631;1604;0;-106.0;1977293
2021-02-16;1113;1961;0;-518.0;1978406
2021-02-16;0;0;0;-1113.0;1978406
2021-02-16;999;2051;0;999.0;1979405
2021-02-16;3979;12241;0;2980.0;1983384
2021-02-16;517;192;0;-3462.0;1983901
2021-02-16;4;1;0;-513.0;1983905
2021-02-16;1;1;0;-3.0;1983906
2021-02-16;15;6;0;14.0;1983921
2021-02-16;1444;1057;0;1429.0;1985365
2021-02-16;20090;41271;0;18646.0;2005455
2021-02-16;6134;14915;0;-13956.0;2011589
2021-02-17;1725;3843;0;-4409.0;2013314
2021-02-17;1850;2953;0;125.0;2015164
2021-02-17;1180;2061;0;-670.0;2016344
2021-02-17;1526;1464;0;346.0;2017870
2021-02-17;713;377;0;-813.0;2018583
2021-02-17;1047;2078;0;334.0;2019630
2021-02-17;3815;12453;0;2768.0;2023445
2021-02-17;19918;43100;0;16103.0;2043363
2021-02-17;6096;16660;0;-13822.0;2049459
2021-02-17;1;0;0;-6095.0;2049460
2021-02-17;516;186;0;515.0;2049976
2021-02-17;1;0;0;-515.0;2049977
2021-02-17;0;0;0;-1.0;2049977
2021-02-17;10;9;0;10.0;2049987
2021-02-17;1438;1016;0;1428.0;2051425
2021-02-18;2599;3619;0;1161.0;2054024
2021-02-18;1965;1256;0;-634.0;2055989
2021-02-18;2403;4313;0;438.0;2058392
2021-02-18;0;0;0;-2403.0;2058392
2021-02-18;8;10;0;8.0;2058400
2021-02-18;1498;2356;0;1490.0;2059898
2021-02-18;1686;2461;0;188.0;2061584
2021-02-18;26817;47802;0;25131.0;2088401
2021-02-18;2315;1823;0;-24502.0;2090716
2021-02-18;4818;12585;0;2503.0;2095534
2021-02-18;638;218;0;-4180.0;2096172
2021-02-18;7997;18747;0;7359.0;2104169
2021-02-18;0;0;0;-7997.0;2104169
2021-02-18;884;414;0;884.0;2105053
2021-02-18;6;0;0;-878.0;2105059
2021-02-19;7484;14272;0;7478.0;2112543
2021-02-19;2;1;0;-7482.0;2112545
2021-02-19;2447;2777;0;2445.0;2114992
2021-02-19;1566;1940;0;-881.0;2116558
2021-02-19;0;1;0;-1566.0;2116558
2021-02-19;2335;3433;0;2335.0;2118893
2021-02-19;2219;1597;0;-116.0;2121112
2021-02-19;1926;1052;0;-293.0;2123038
2021-02-19;0;0;0;-1926.0;2123038
2021-02-19;1465;1811;0;1465.0;2124503
2021-02-19;16;6;0;-1449.0;2124519
2021-02-19;25676;37837;0;25660.0;2150195
2021-02-19;554;191;0;-25122.0;2150749
2021-02-19;823;342;0;269.0;2151572
2021-02-19;4839;10414;0;4016.0;2156411
2021-02-20;2581;5105;0;-2258.0;2158992
2021-02-20;2;0;0;-2579.0;2158994
2021-02-20;449;518;0;447.0;2159443
2021-02-20;0;0;0;-449.0;2159443
2021-02-20;7782;12636;0;7782.0;2167225
2021-02-20;583;849;0;-7199.0;2167808
2021-02-20;0;0;0;-583.0;2167808
2021-02-20;1687;4283;0;1687.0;2169495
2021-02-20;4;4;0;-1683.0;2169499
2021-02-20;129;51;0;125.0;2169628
2021-02-20;468;159;0;339.0;2170096
2021-02-20;372;474;0;-96.0;2170468
2021-02-20;554;293;0;182.0;2171022
2021-02-20;806;849;0;252.0;2171828
2021-02-20;147;51;0;-659.0;2171975
2021-02-21;1415;2450;0;1268.0;2173390
2021-02-21;36;7;0;-1379.0;2173426
2021-02-21;7;0;0;-29.0;2173433
2021-02-21;132;190;0;125.0;2173565
2021-02-21;381;993;0;249.0;2173946
2021-02-21;104;27;0;-277.0;2174050
2021-02-21;55;28;0;-49.0;2174105
2021-02-21;94;114;0;39.0;2174199
2021-02-21;131;69;0;37.0;2174330
2021-02-21;68;111;0;-63.0;2174398
2021-02-21;256;726;0;188.0;2174654
2021-02-21;150;185;0;-106.0;2174804
2021-02-21;0;0;0;-150.0;2174804
2021-02-21;1;0;0;1.0;2174805
2021-02-21;0;0;0;-1.0;2174805
2021-02-22;3354;11183;0;3354.0;2178159
2021-02-22;1;0;0;-3353.0;2178160
2021-02-22;401;118;0;400.0;2178561
2021-02-22;15582;32546;0;15181.0;2194143
2021-02-22;1532;2214;0;-14050.0;2195675
2021-02-22;1096;593;0;-436.0;2196771
2021-02-22;0;0;0;-1096.0;2196771
2021-02-22;1;3;0;1.0;2196772
2021-02-22;1;0;0;0.0;2196773
2021-02-22;1226;913;0;1225.0;2197999
2021-02-22;747;1099;0;-479.0;2198746
2021-02-22;937;1384;0;190.0;2199683
2021-02-22;1245;1991;0;308.0;2200928
2021-02-22;4521;12828;0;3276.0;2205449
2021-02-22;520;219;0;-4001.0;2205969
2021-02-23;9;5;0;-511.0;2205978
2021-02-23;6768;15032;0;6759.0;2212746
2021-02-23;561;156;0;-6207.0;2213307
2021-02-23;1216;1269;0;655.0;2214523
2021-02-23;22462;36440;0;21246.0;2236985
2021-02-23;1461;655;0;-21001.0;2238446
2021-02-23;5;0;0;-1456.0;2238451
2021-02-23;1806;998;0;1801.0;2240257
2021-02-23;1287;1596;0;-519.0;2241544
2021-02-23;1980;2181;0;693.0;2243524
2021-02-23;0;0;0;-1980.0;2243524
2021-02-23;0;0;0;0.0;2243524
2021-02-23;708;255;0;708.0;2244232
2021-02-23;2202;2549;0;1494.0;2246434
2021-02-23;4459;11744;0;2257.0;2250893
2021-02-24;2372;2561;0;-2087.0;2253265
2021-02-24;2143;1317;0;-229.0;2255408
2021-02-24;7128;14604;0;4985.0;2262536
2021-02-24;4660;11088;0;-2468.0;2267196
2021-02-24;3;1;0;-4657.0;2267199
2021-02-24;580;121;0;577.0;2267779
2021-02-24;695;203;0;115.0;2268474
2021-02-24;11;7;0;-684.0;2268485
2021-02-24;0;0;0;-11.0;2268485
2021-02-24;25442;35234;0;25442.0;2293927
2021-02-24;1467;601;0;-23975.0;2295394
2021-02-24;0;1;0;-1467.0;2295394
2021-02-24;1799;979;0;1799.0;2297193
2021-02-24;1541;1636;0;-258.0;2298734
2021-02-24;3043;2115;0;1502.0;2301777
2021-02-25;8736;15509;0;5693.0;2310513
2021-02-25;0;0;0;-8736.0;2310513
2021-02-25;2830;1341;0;2830.0;2313343
2021-02-25;4;1;0;-2826.0;2313347
2021-02-25;2107;847;0;2103.0;2315454
2021-02-25;822;170;0;-1285.0;2316276
2021-02-25;10806;2872;0;9984.0;2327082
2021-02-25;1;1;0;-10805.0;2327083
2021-02-25;2805;2803;0;2804.0;2329888
2021-02-25;5396;10717;0;2591.0;2335284
2021-02-25;45725;38180;0;40329.0;2381009
2021-02-25;14;11;0;-45711.0;2381023
2021-02-25;9129;1730;0;9115.0;2390152
2021-02-25;892;346;0;-8237.0;2391044
2021-02-25;2183;1828;0;1291.0;2393227
2021-02-26;2934;1005;0;751.0;2396161
2021-02-26;53041;31087;0;50107.0;2449202
2021-02-26;5613;9312;0;-47428.0;2454815
2021-02-26;724;150;0;-4889.0;2455539
2021-02-26;8162;12356;0;7438.0;2463701
2021-02-26;5;0;0;-8157.0;2463706
2021-02-26;2108;640;0;2103.0;2465814
2021-02-26;14871;2284;0;12763.0;2480685
2021-02-26;911;254;0;-13960.0;2481596
2021-02-26;2;0;0;-909.0;2481598
2021-02-26;3;0;0;1.0;2481601
2021-02-26;12463;1362;0;12460.0;2494064
2021-02-26;25;6;0;-12438.0;2494089
2021-02-26;2784;2294;0;2759.0;2496873
2021-02-26;2436;1424;0;-348.0;2499309
2021-02-27;3;0;0;-2433.0;2499312
2021-02-27;13;2;0;10.0;2499325
2021-02-27;219;45;0;206.0;2499544
2021-02-27;1048;239;0;829.0;2500592
2021-02-27;705;132;0;-343.0;2501297
2021-02-27;26078;10659;0;25373.0;2527375
2021-02-27;9211;808;0;-16867.0;2536586
2021-02-27;1993;3382;0;-7218.0;2538579
2021-02-27;1093;427;0;-900.0;2539672
2021-02-27;2999;4424;0;1906.0;2542671
2021-02-27;237;55;0;-2762.0;2542908
2021-02-27;1027;683;0;790.0;2543935
2021-02-27;7528;462;0;6501.0;2551463
2021-02-27;1;0;0;-7527.0;2551464
2021-02-27;1;0;0;0.0;2551465
2021-02-28;420;486;0;419.0;2551885
2021-02-28;174;55;0;-246.0;2552059
2021-02-28;130;38;0;-44.0;2552189
2021-02-28;66;14;0;-64.0;2552255
2021-02-28;0;0;0;-66.0;2552255
2021-02-28;186;79;0;186.0;2552441
2021-02-28;627;142;0;441.0;2553068
2021-02-28;2956;1744;0;2329.0;2556024
2021-02-28;43;9;0;-2913.0;2556067
2021-02-28;9;1;0;-34.0;2556076
2021-02-28;0;0;0;-9.0;2556076
2021-02-28;269;120;0;269.0;2556345
2021-02-28;476;96;0;207.0;2556821
2021-02-28;556;704;0;80.0;2557377
2021-02-28;0;0;0;-556.0;2557377
2021-03-01;498;113;0;498.0;2557875
2021-03-01;1624;1085;0;1126.0;2559499
2021-03-01;1;0;0;-1623.0;2559500
2021-03-01;3;1;0;2.0;2559503
2021-03-01;2631;1819;0;2628.0;2562134
2021-03-01;539;154;0;-2092.0;2562673
2021-03-01;5627;8488;0;5088.0;2568300
2021-03-01;7789;9988;0;2162.0;2576089
2021-03-01;4509;1303;0;-3280.0;2580598
2021-03-01;7;0;0;-4502.0;2580605
2021-03-01;29606;24865;0;29599.0;2610211
2021-03-01;1178;387;0;-28428.0;2611389
2021-03-01;1459;612;0;281.0;2612848
2021-03-01;21;7;0;-1438.0;2612869
2021-03-01;3720;908;0;3699.0;2616589
2021-03-02;3881;2310;0;161.0;2620470
2021-03-02;2200;853;0;-1681.0;2622670
2021-03-02;17;7;0;-2183.0;2622687
2021-03-02;704;260;0;687.0;2623391
2021-03-02;7497;9561;0;6793.0;2630888
2021-03-02;7485;1290;0;-12.0;2638373
2021-03-02;46429;30306;0;38944.0;2684802
2021-03-02;10881;12180;0;-35548.0;2695683
2021-03-02;1674;538;0;-9207.0;2697357
2021-03-02;1;1;0;-1673.0;2697358
2021-03-02;592;147;0;591.0;2697950
2021-03-02;8810;1788;0;8218.0;2706760
2021-03-02;2685;1371;0;-6125.0;2709445
2021-03-02;2;0;0;-2683.0;2709447
2021-03-02;0;0;0;-2.0;2709447
2021-03-03;18;19;0;18.0;2709465
2021-03-03;2451;864;0;2433.0;2711916
2021-03-03;11619;11950;0;9168.0;2723535
2021-03-03;9091;1273;0;-2528.0;2732626
2021-03-03;1838;562;0;-7253.0;2734464
2021-03-03;3883;1400;0;2045.0;2738347
2021-03-03;54222;29606;0;50339.0;2792569
2021-03-03;8189;8881;0;-46033.0;2800758
2021-03-03;630;145;0;-7559.0;2801388
2021-03-03;5084;2352;0;4454.0;2806472
2021-03-03;804;212;0;-4280.0;2807276
2021-03-03;2;0;0;-802.0;2807278
2021-03-03;10607;1948;0;10605.0;2817885
2021-03-03;4;0;0;-10603.0;2817889
2021-03-03;2;0;0;-2.0;2817891
2021-03-04;6798;1853;0;6796.0;2824689
2021-03-04;3384;1118;0;-3414.0;2828073
2021-03-04;14005;12367;0;10621.0;2842078
2021-03-04;14167;1633;0;162.0;2856245
2021-03-04;978;309;0;-13189.0;2857223
2021-03-04;77194;32204;0;76216.0;2934417
2021-03-04;1;0;0;-77193.0;2934418
2021-03-04;2403;798;0;2402.0;2936821
2021-03-04;1;0;0;-2402.0;2936822
2021-03-04;16921;2318;0;16920.0;2953743
2021-03-04;2;0;0;-16919.0;2953745
2021-03-04;782;188;0;780.0;2954527
2021-03-04;9685;8923;0;8903.0;2964212
2021-03-04;22;9;0;-9663.0;2964234
2021-03-04;8045;2688;0;8023.0;2972279
2021-03-05;5;2;0;-8040.0;2972284
2021-03-05;3214;760;0;3209.0;2975498
2021-03-05;9624;1541;0;6410.0;2985122
2021-03-05;1064;195;0;-8560.0;2986186
2021-03-05;14469;11218;0;13405.0;3000655
2021-03-05;10443;7886;0;-4026.0;3011098
2021-03-05;11372;2468;0;929.0;3022470
2021-03-05;4534;1073;0;-6838.0;3027004
2021-03-05;94117;29208;0;89583.0;3121121
2021-03-05;4;0;0;-94113.0;3121125
2021-03-05;21132;2232;0;21128.0;3142257
2021-03-05;16935;1530;0;-4197.0;3159192
2021-03-05;2;0;0;-16933.0;3159194
2021-03-05;1289;295;0;1287.0;3160483
2021-03-05;30;8;0;-1259.0;3160513
2021-03-06;0;0;0;-30.0;3160513
2021-03-06;0;0;0;0.0;3160513
2021-03-06;698;79;0;698.0;3161211
2021-03-06;19142;1018;0;18444.0;3180353
2021-03-06;99344;10142;0;80202.0;3279697
2021-03-06;686;77;0;-98658.0;3280383
2021-03-06;35;6;0;-651.0;3280418
2021-03-06;14630;612;0;14595.0;3295048
2021-03-06;15651;924;0;1021.0;3310699
2021-03-06;11;2;0;-15640.0;3310710
2021-03-06;3765;312;0;3754.0;3314475
2021-03-06;16956;3646;0;13191.0;3331431
2021-03-06;13271;2746;0;-3685.0;3344702
2021-03-06;2155;204;0;-11116.0;3346857
2021-03-06;12344;515;0;10189.0;3359201
2021-03-07;54462;3095;0;42118.0;3413663
2021-03-07;11902;815;0;-42560.0;3425565
2021-03-07;7215;259;0;-4687.0;3432780
2021-03-07;4;0;0;-7211.0;3432784
2021-03-07;27;3;0;23.0;3432811
2021-03-07;9370;618;0;9343.0;3442181
2021-03-07;374;41;0;-8996.0;3442555
2021-03-07;1208;136;0;834.0;3443763
2021-03-07;10015;307;0;8807.0;3453778
2021-03-07;1;0;0;-10014.0;3453779
2021-03-07;4917;256;0;4916.0;3458696
2021-03-07;7035;459;0;2118.0;3465731
2021-03-07;0;0;0;-7035.0;3465731
2021-03-07;2041;156;0;2041.0;3467772
2021-03-07;353;45;0;-1688.0;3468125
2021-03-08;8031;7478;0;7678.0;3476156
2021-03-08;19;9;0;-8012.0;3476175
2021-03-08;0;0;0;-19.0;3476175
2021-03-08;5968;1239;0;5968.0;3482143
2021-03-08;2305;643;0;-3663.0;3484448
2021-03-08;3;1;0;-2302.0;3484451
2021-03-08;47419;23485;0;47416.0;3531870
2021-03-08;11022;9389;0;-36397.0;3542892
2021-03-08;4710;922;0;-6312.0;3547602
2021-03-08;7099;1916;0;2389.0;3554701
2021-03-08;647;125;0;-6452.0;3555348
2021-03-08;784;186;0;137.0;3556132
2021-03-08;1657;413;0;873.0;3557789
2021-03-08;0;0;0;-1657.0;3557789
2021-03-08;5174;1164;0;5174.0;3562963
2021-03-09;9266;1419;0;4092.0;3572229
2021-03-09;1016;210;0;-8250.0;3573245
2021-03-09;8931;1073;0;7915.0;3582176
2021-03-09;847;155;0;-8084.0;3583023
2021-03-09;12314;2353;0;11467.0;3595337
2021-03-09;11374;1805;0;-940.0;3606711
2021-03-09;1;0;0;-11373.0;3606712
2021-03-09;3481;801;0;3480.0;3610193
2021-03-09;78015;26859;0;74534.0;3688208
2021-03-09;5;0;0;-78010.0;3688213
2021-03-09;11908;7960;0;11903.0;3700121
2021-03-09;28;6;0;-11880.0;3700149
2021-03-09;16448;10509;0;16420.0;3716597
2021-03-09;2;0;0;-16446.0;3716599
2021-03-09;2394;568;0;2392.0;3718993
2021-03-10;13433;2479;0;11039.0;3732426
2021-03-10;9033;1214;0;-4400.0;3741459
2021-03-10;2420;690;0;-6613.0;3743879
2021-03-10;12261;7514;0;9841.0;3756140
2021-03-10;17222;10373;0;4961.0;3773362
2021-03-10;840;149;0;-16382.0;3774202
2021-03-10;970;240;0;130.0;3775172
2021-03-10;11577;1822;0;10607.0;3786749
2021-03-10;81264;26852;0;69687.0;3868013
2021-03-10;0;0;0;-81264.0;3868013
2021-03-10;8;1;0;8.0;3868021
2021-03-10;45;12;0;37.0;3868066
2021-03-10;2;2;0;-43.0;3868068
2021-03-10;10017;1510;0;10015.0;3878085
2021-03-10;3436;846;0;-6581.0;3881521
2021-03-11;7;1;0;-3429.0;3881528
2021-03-11;14600;7297;0;14593.0;3896128
2021-03-11;4694;1239;0;-9906.0;3900822
2021-03-11;13583;1644;0;8889.0;3914405
2021-03-11;19542;2988;0;5959.0;3933947
2021-03-11;1211;331;0;-18331.0;3935158
2021-03-11;17222;2348;0;16011.0;3952380
2021-03-11;2;0;0;-17220.0;3952382
2021-03-11;39;6;0;37.0;3952421
2021-03-11;3;0;0;-36.0;3952424
2021-03-11;936;201;0;933.0;3953360
2021-03-11;20259;10990;0;19323.0;3973619
2021-03-11;3109;897;0;-17150.0;3976728
2021-03-11;110559;29919;0;107450.0;4087287
2021-03-11;15352;1977;0;-95207.0;4102639
2021-03-12;20801;9226;0;5449.0;4123440
2021-03-12;53;7;0;-20748.0;4123493
2021-03-12;17890;1508;0;17837.0;4141383
2021-03-12;15275;6244;0;-2615.0;4156658
2021-03-12;8;1;0;-15267.0;4156666
2021-03-12;5;1;0;-3.0;4156671
2021-03-12;21014;1859;0;21009.0;4177685
2021-03-12;1399;319;0;-19615.0;4179084
2021-03-12;136701;26474;0;135302.0;4315785
2021-03-12;6061;1128;0;-130640.0;4321846
2021-03-12;3962;911;0;-2099.0;4325808
2021-03-12;1164;208;0;-2798.0;4326972
2021-03-12;23227;2315;0;22063.0;4350199
2021-03-12;2;0;0;-23225.0;4350201
2021-03-12;25840;2747;0;25838.0;4376041
2021-03-13;1;1;0;-25839.0;4376042
2021-03-13;18821;990;0;18820.0;4394863
2021-03-13;23635;1194;0;4814.0;4418498
2021-03-13;1;0;0;-23634.0;4418499
2021-03-13;2251;243;0;2250.0;4420750
2021-03-13;11493;2151;0;9242.0;4432243
2021-03-13;109418;9558;0;97925.0;4541661
2021-03-13;14222;628;0;-95196.0;4555883
2021-03-13;36;9;0;-14186.0;4555919
2021-03-13;590;49;0;554.0;4556509
2021-03-13;15019;3097;0;14429.0;4571528
2021-03-13;4181;345;0;-10838.0;4575709
2021-03-13;18444;772;0;14263.0;4594153
2021-03-13;5;0;0;-18439.0;4594158
2021-03-13;719;79;0;714.0;4594877
2021-03-14;3955;206;0;3236.0;4598832
2021-03-14;28173;2197;0;24218.0;4627005
2021-03-14;5365;588;0;-22808.0;4632370
2021-03-14;257;19;0;-5108.0;4632627
2021-03-14;1498;128;0;1241.0;4634125
2021-03-14;791;91;0;-707.0;4634916
2021-03-14;3684;255;0;2893.0;4638600
2021-03-14;0;0;0;-3684.0;4638600
2021-03-14;4113;420;0;4113.0;4642713
2021-03-14;0;0;0;-4113.0;4642713
2021-03-14;4;0;0;4.0;4642717
2021-03-14;2661;152;0;2657.0;4645378
2021-03-14;284;28;0;-2377.0;4645662
2021-03-14;17;0;0;-267.0;4645679
2021-03-14;5544;310;0;5527.0;4651223
2021-03-15;735;165;0;-4809.0;4651958
2021-03-15;654;125;0;-81.0;4652612
2021-03-15;2838;573;0;2184.0;4655450
2021-03-15;26;7;0;-2812.0;4655476
2021-03-15;1800;406;0;1774.0;4657276
2021-03-15;12662;1737;0;10862.0;4669938
2021-03-15;1;0;0;-12661.0;4669939
2021-03-15;71023;15833;0;71022.0;4740962
2021-03-15;17775;5721;0;-53248.0;4758737
2021-03-15;8608;1020;0;-9167.0;4767345
2021-03-15;1;0;0;-8607.0;4767346
2021-03-15;7;0;0;6.0;4767353
2021-03-15;5683;784;0;5676.0;4773036
2021-03-15;12900;4208;0;7217.0;4785936
2021-03-15;7333;1087;0;-5567.0;4793269
2021-03-16;20483;6773;0;13150.0;4813752
2021-03-16;349;108;0;-20134.0;4814101
2021-03-16;2955;865;0;2606.0;4817056
2021-03-16;1848;790;0;-1107.0;4818904
2021-03-16;18;6;0;-1830.0;4818922
2021-03-16;3726;1317;0;3708.0;4822648
2021-03-16;1302;519;0;-2424.0;4823950
2021-03-16;14719;4500;0;13417.0;4838669
2021-03-16;9405;2115;0;-5314.0;4848074
2021-03-16;1;0;0;-9404.0;4848075
2021-03-16;6;0;0;5.0;4848081
2021-03-16;442;215;0;436.0;4848523
2021-03-16;5471;1245;0;5029.0;4853994
2021-03-16;2;0;0;-5469.0;4853996
2021-03-16;60727;18453;0;60725.0;4914723
2021-03-17;1380;553;0;-59347.0;4916103
2021-03-17;10334;2085;0;8954.0;4926437
2021-03-17;63702;17814;0;53368.0;4990139
2021-03-17;3885;1297;0;-59817.0;4994024
2021-03-17;39;7;0;-3846.0;4994063
2021-03-17;3059;858;0;3020.0;4997122
2021-03-17;536;177;0;-2523.0;4997658
2021-03-17;1940;715;0;1404.0;4999598
2021-03-17;0;0;0;-1940.0;4999598
2021-03-17;15041;4322;0;15041.0;5014639
2021-03-17;5874;1230;0;-9167.0;5020513
2021-03-17;2;0;0;-5872.0;5020515
2021-03-17;21188;6456;0;21186.0;5041703
2021-03-17;1;0;0;-21187.0;5041704
2021-03-17;423;114;0;422.0;5042127
2021-03-18;70977;20556;0;70554.0;5113104
2021-03-18;6445;1455;0;-64532.0;5119549
2021-03-18;26;6;0;-6419.0;5119575
2021-03-18;1725;658;0;1699.0;5121300
2021-03-18;3757;1016;0;2032.0;5125057
2021-03-18;1;0;0;-3756.0;5125058
2021-03-18;16453;4664;0;16452.0;5141511
2021-03-18;4621;1552;0;-11832.0;5146132
2021-03-18;22965;7373;0;18344.0;5169097
2021-03-18;462;153;0;-22503.0;5169559
2021-03-18;2445;1008;0;1983.0;5172004
2021-03-18;599;242;0;-1846.0;5172603
2021-03-18;8;3;0;-591.0;5172611
2021-03-18;11468;2426;0;11460.0;5184079
2021-03-18;2;0;0;-11466.0;5184081
2021-03-19;823;218;0;821.0;5184904
2021-03-19;9544;1075;0;8721.0;5194448
2021-03-19;28;5;0;-9516.0;5194476
2021-03-19;2;1;0;-26.0;5194478
2021-03-19;20074;2193;0;20072.0;5214552
2021-03-19;11882;1591;0;-8192.0;5226434
2021-03-19;2;0;0;-11880.0;5226436
2021-03-19;102850;18585;0;102848.0;5329286
2021-03-19;1;1;0;-102849.0;5329287
2021-03-19;16430;4257;0;16429.0;5345717
2021-03-19;3735;805;0;-12695.0;5349452
2021-03-19;14681;1410;0;10946.0;5364133
2021-03-19;22664;6280;0;7983.0;5386797
2021-03-19;2293;608;0;-20371.0;5389090
2021-03-19;691;140;0;-1602.0;5389781
2021-03-20;13278;595;0;12587.0;5403059
2021-03-20;405;60;0;-12873.0;5403464
2021-03-20;29;3;0;-376.0;5403493
2021-03-20;12129;2258;0;12100.0;5415622
2021-03-20;1;0;0;-12128.0;5415623
2021-03-20;2561;243;0;2560.0;5418184
2021-03-20;9395;489;0;6834.0;5427579
2021-03-20;8966;1550;0;-429.0;5436545
2021-03-20;17297;925;0;8331.0;5453842
2021-03-20;0;0;0;-17297.0;5453842
2021-03-20;76464;7009;0;76464.0;5530306
2021-03-20;4;0;0;-76460.0;5530310
2021-03-20;10731;660;0;10727.0;5541041
2021-03-20;1315;181;0;-9416.0;5542356
2021-03-20;353;45;0;-962.0;5542709
2021-03-21;4399;225;0;4046.0;5547108
2021-03-21;0;0;0;-4399.0;5547108
2021-03-21;1390;118;0;1390.0;5548498
2021-03-21;0;0;0;-1390.0;5548498
2021-03-21;283;34;0;283.0;5548781
2021-03-21;3350;388;0;3067.0;5552131
2021-03-21;21941;1693;0;18591.0;5574072
2021-03-21;2529;268;0;-19412.0;5576601
2021-03-21;891;103;0;-1638.0;5577492
2021-03-21;9;1;0;-882.0;5577501
2021-03-21;2260;131;0;2251.0;5579761
2021-03-21;3;0;0;-2257.0;5579764
2021-03-21;3377;156;0;3374.0;5583141
2021-03-21;3134;229;0;-243.0;5586275
2021-03-21;316;40;0;-2818.0;5586591
2021-03-22;75712;17224;0;75396.0;5662303
2021-03-22;2617;624;0;-73095.0;5664920
2021-03-22;10612;1258;0;7995.0;5675532
2021-03-22;5;0;0;-10607.0;5675537
2021-03-22;525;136;0;520.0;5676062
2021-03-22;3;0;0;-522.0;5676065
2021-03-22;16974;5997;0;16971.0;5693039
2021-03-22;15130;2075;0;-1844.0;5708169
2021-03-22;656;185;0;-14474.0;5708825
2021-03-22;0;0;0;-656.0;5708825
2021-03-22;1728;477;0;1728.0;5710553
2021-03-22;12857;4389;0;11129.0;5723410
2021-03-22;27;4;0;-12830.0;5723437
2021-03-22;7688;1220;0;7661.0;5731125
2021-03-22;6890;859;0;-798.0;5738015
2021-03-23;12915;1708;0;6025.0;5750930
2021-03-23;640;157;0;-12275.0;5751570
2021-03-23;21926;7334;0;21286.0;5773496
2021-03-23;3227;916;0;-18699.0;5776723
2021-03-23;2131;730;0;-1096.0;5778854
2021-03-23;40;7;0;-2091.0;5778894
2021-03-23;1;0;0;-39.0;5778895
2021-03-23;6;0;0;5.0;5778901
2021-03-23;18235;1641;0;18229.0;5797136
2021-03-23;16792;5155;0;-1443.0;5813928
2021-03-23;846;269;0;-15946.0;5814774
2021-03-23;24498;2740;0;23652.0;5839272
2021-03-23;113391;21840;0;88893.0;5952663
2021-03-23;1;1;0;-113390.0;5952664
2021-03-23;12133;1182;0;12132.0;5964797
2021-03-24;13997;1749;0;1864.0;5978794
2021-03-24;2;0;0;-13995.0;5978796
2021-03-24;922;245;0;920.0;5979718
2021-03-24;0;0;0;-922.0;5979718
2021-03-24;116364;22487;0;116364.0;6096082
2021-03-24;2271;597;0;-114093.0;6098353
2021-03-24;3589;812;0;1318.0;6101942
2021-03-24;18967;1741;0;15378.0;6120909
2021-03-24;21442;7725;0;2475.0;6142351
2021-03-24;729;183;0;-20713.0;6143080
2021-03-24;12960;1258;0;12231.0;6156040
2021-03-24;36;3;0;-12924.0;6156076
2021-03-24;25457;2844;0;25421.0;6181533
2021-03-24;2;1;0;-25455.0;6181535
2021-03-24;15990;5329;0;15988.0;6197525
2021-03-25;4513;991;0;-11477.0;6202038
2021-03-25;2;1;0;-4511.0;6202040
2021-03-25;25278;8057;0;25276.0;6227318
2021-03-25;36471;3160;0;11193.0;6263789
2021-03-25;19180;2024;0;-17291.0;6282969
2021-03-25;18990;5364;0;-190.0;6301959
2021-03-25;34;10;0;-18956.0;6301993
2021-03-25;787;233;0;753.0;6302780
2021-03-25;2968;757;0;2181.0;6305748
2021-03-25;18719;1518;0;15751.0;6324467
2021-03-25;0;0;0;-18719.0;6324467
2021-03-25;155910;24358;0;155910.0;6480377
2021-03-25;8;0;0;-155902.0;6480385
2021-03-25;1141;288;0;1133.0;6481526
2021-03-25;27819;1955;0;26678.0;6509345
2021-03-26;23407;7316;0;-4412.0;6532752
2021-03-26;17834;4974;0;-5573.0;6550586
2021-03-26;20251;1435;0;2417.0;6570837
2021-03-26;977;212;0;-19274.0;6571814
2021-03-26;39152;2989;0;38175.0;6610966
2021-03-26;21472;2111;0;-17680.0;6632438
2021-03-26;162614;22888;0;141142.0;6795052
2021-03-26;29656;1855;0;-132958.0;6824708
2021-03-26;2;0;0;-29654.0;6824710
2021-03-26;35;5;0;33.0;6824745
2021-03-26;3;1;0;-32.0;6824748
2021-03-26;3442;726;0;3439.0;6828190
2021-03-26;5163;945;0;1721.0;6833353
2021-03-26;1217;319;0;-3946.0;6834570
2021-03-26;3;0;0;-1214.0;6834573
2021-03-27;37;3;0;34.0;6834610
2021-03-27;14498;906;0;14461.0;6849108
2021-03-27;13289;1025;0;-1209.0;6862397
2021-03-27;2142;282;0;-11147.0;6864539
2021-03-27;3755;415;0;1613.0;6868294
2021-03-27;629;86;0;-3126.0;6868923
2021-03-27;10196;3186;0;9567.0;6879119
2021-03-27;7725;2147;0;-2471.0;6886844
2021-03-27;5;0;0;-7720.0;6886849
2021-03-27;23081;1416;0;23076.0;6909930
2021-03-27;10747;708;0;-12334.0;6920677
2021-03-27;1;0;0;-10746.0;6920678
2021-03-27;0;0;0;-1.0;6920678
2021-03-27;780;117;0;780.0;6921458
2021-03-27;86885;10291;0;86105.0;7008343
2021-03-28;9;0;0;-86876.0;7008352
2021-03-28;25396;2868;0;25387.0;7033748
2021-03-28;2392;166;0;-23004.0;7036140
2021-03-28;0;0;0;-2392.0;7036140
2021-03-28;1032;94;0;1032.0;7037172
2021-03-28;1567;155;0;535.0;7038739
2021-03-28;2;0;0;-1565.0;7038741
2021-03-28;2104;563;0;2102.0;7040845
2021-03-28;2690;753;0;586.0;7043535
2021-03-28;387;52;0;-2303.0;7043922
2021-03-28;3660;288;0;3273.0;7047582
2021-03-28;3343;256;0;-317.0;7050925
2021-03-28;7834;495;0;4491.0;7058759
2021-03-28;374;45;0;-7460.0;7059133
2021-03-28;2;1;0;-372.0;7059135
2021-03-29;8705;1143;0;8703.0;7067840
2021-03-29;1012;235;0;-7693.0;7068852
2021-03-29;13386;1956;0;12374.0;7082238
2021-03-29;1;0;0;-13385.0;7082239
2021-03-29;9981;6881;0;9980.0;7092220
2021-03-29;2464;547;0;-7517.0;7094684
2021-03-29;12828;9475;0;10364.0;7107512
2021-03-29;3602;712;0;-9226.0;7111114
2021-03-29;25519;3607;0;21917.0;7136633
2021-03-29;17;3;0;-25502.0;7136650
2021-03-29;88809;26288;0;88792.0;7225459
2021-03-29;896;189;0;-87913.0;7226355
2021-03-29;8;0;0;-888.0;7226363
2021-03-29;0;0;0;-8.0;7226363
2021-03-29;10390;1540;0;10390.0;7236753
2021-03-30;16487;12478;0;6097.0;7253240
2021-03-30;1195;196;0;-15292.0;7254435
2021-03-30;2;0;0;-1193.0;7254437
2021-03-30;35308;4747;0;35306.0;7289745
2021-03-30;1367;336;0;-33941.0;7291112
2021-03-30;28;10;0;-1339.0;7291140
2021-03-30;4911;1067;0;4883.0;7296051
2021-03-30;4;0;0;-4907.0;7296055
2021-03-30;12715;8803;0;12711.0;7308770
2021-03-30;3310;737;0;-9405.0;7312080
2021-03-30;8;0;0;-3302.0;7312088
2021-03-30;13487;1614;0;13479.0;7325575
2021-03-30;20358;2570;0;6871.0;7345933
2021-03-30;124443;34658;0;104085.0;7470376
2021-03-30;15263;2100;0;-109180.0;7485639
2021-03-31;6;0;0;-15257.0;7485645
2021-03-31;1565;329;0;1559.0;7487210
2021-03-31;1;0;0;-1564.0;7487211
2021-03-31;16799;2551;0;16798.0;7504010
2021-03-31;48;8;0;-16751.0;7504058
2021-03-31;1;1;0;-47.0;7504059
2021-03-31;111954;36142;0;111953.0;7616013
2021-03-31;15190;13110;0;-96764.0;7631203
2021-03-31;11839;1675;0;-3351.0;7643042
2021-03-31;14288;2186;0;2449.0;7657330
2021-03-31;5458;1137;0;-8830.0;7662788
2021-03-31;10836;9166;0;5378.0;7673624
2021-03-31;30831;5003;0;19995.0;7704455
2021-03-31;3705;754;0;-27126.0;7708160
2021-03-31;1387;222;0;-2318.0;7709547
2021-04-01;4669;1025;0;3282.0;7714216
2021-04-01;133837;44827;0;129168.0;7848053
2021-04-01;1908;401;0;-131929.0;7849961
2021-04-01;20777;3365;0;18869.0;7870738
2021-04-01;6796;1347;0;-13981.0;7877534
2021-04-01;52;5;0;-6744.0;7877586
2021-04-01;4;0;0;-48.0;7877590
2021-04-01;4;0;0;0.0;7877594
2021-04-01;17133;15886;0;17129.0;7894727
2021-04-01;14954;2182;0;-2179.0;7909681
2021-04-01;12243;11163;0;-2711.0;7921924
2021-04-01;17833;2795;0;5590.0;7939757
2021-04-01;15;0;0;-17818.0;7939772
2021-04-01;1713;289;0;1698.0;7941485
2021-04-01;35736;6369;0;34023.0;7977221
2021-04-02;14446;2035;0;-21290.0;7991667
2021-04-02;47;16;0;-14399.0;7991714
2021-04-02;9;2;0;-38.0;7991723
2021-04-02;1355;279;0;1346.0;7993078
2021-04-02;4191;986;0;2836.0;7997269
2021-04-02;10290;11262;0;6099.0;8007559
2021-04-02;32131;6305;0;21841.0;8039690
2021-04-02;6108;1396;0;-26023.0;8045798
2021-04-02;0;1;0;-6108.0;8045798
2021-04-02;120852;45233;0;120852.0;8166650
2021-04-02;17248;2836;0;-103604.0;8183898
2021-04-02;13884;16488;0;-3364.0;8197782
2021-04-02;19564;3242;0;5680.0;8217346
2021-04-02;1574;385;0;-17990.0;8218920
2021-04-02;5;0;0;-1569.0;8218925
2021-04-03;10307;1764;0;10302.0;8229232
2021-04-03;10;1;0;-10297.0;8229242
2021-04-03;2202;461;0;2192.0;8231444
2021-04-03;5484;10542;0;3282.0;8236928
2021-04-03;7711;1244;0;2227.0;8244639
2021-04-03;689;157;0;-7022.0;8245328
2021-04-03;4390;7732;0;3701.0;8249718
2021-04-03;16809;4182;0;12419.0;8266527
2021-04-03;10250;2116;0;-6559.0;8276777
2021-04-03;3936;853;0;-6314.0;8280713
2021-04-03;38;12;0;-3898.0;8280751
2021-04-03;693;156;0;655.0;8281444
2021-04-03;62522;29220;0;61829.0;8343966
2021-04-03;2;0;0;-62520.0;8343968
2021-04-03;1;0;0;-1.0;8343969
2021-04-04;1229;2274;0;1228.0;8345198
2021-04-04;1140;177;0;-89.0;8346338
2021-04-04;20351;9064;0;19211.0;8366689
2021-04-04;2655;707;0;-17696.0;8369344
2021-04-04;5620;1433;0;2965.0;8374964
2021-04-04;3;0;0;-5617.0;8374967
2021-04-04;1486;2991;0;1483.0;8376453
2021-04-04;1901;435;0;415.0;8378354
2021-04-04;7;0;0;-1894.0;8378361
2021-04-04;1827;269;0;1820.0;8380188
2021-04-04;437;64;0;-1390.0;8380625
2021-04-04;3601;639;0;3164.0;8384226
2021-04-04;2;0;0;-3599.0;8384228
2021-04-04;407;73;0;405.0;8384635
2021-04-04;36;2;0;-371.0;8384671
2021-04-05;2101;1582;0;2065.0;8386772
2021-04-05;8;1;0;-2093.0;8386780
2021-04-05;3428;524;0;3420.0;8390208
2021-04-05;652;61;0;-2776.0;8390860
2021-04-05;1515;156;0;863.0;8392375
2021-04-05;27809;5693;0;26294.0;8420184
2021-04-05;1945;1231;0;-25864.0;8422129
2021-04-05;2;0;0;-1943.0;8422131
2021-04-05;8520;897;0;8518.0;8430651
2021-04-05;2052;240;0;-6468.0;8432703
2021-04-05;856;65;0;-1196.0;8433559
2021-04-05;4167;548;0;3311.0;8437726
2021-04-05;3;2;0;-4164.0;8437729
2021-04-05;2459;386;0;2456.0;8440188
2021-04-05;101;0;0;-2358.0;8440289
2021-04-06;1241;331;0;1140.0;8441530
2021-04-06;6;0;0;-1235.0;8441536
2021-04-06;29091;7847;0;29085.0;8470627
2021-04-06;10404;18982;0;-18687.0;8481031
2021-04-06;12159;2877;0;1755.0;8493190
2021-04-06;3159;885;0;-9000.0;8496349
2021-04-06;93111;52716;0;89952.0;8589460
2021-04-06;13034;3952;0;-80077.0;8602494
2021-04-06;1;0;0;-13033.0;8602495
2021-04-06;4;1;0;3.0;8602499
2021-04-06;4946;1386;0;4942.0;8607445
2021-04-06;9263;2337;0;4317.0;8616708
2021-04-06;8508;13833;0;-755.0;8625216
2021-04-06;53;24;0;-8455.0;8625269
2021-04-06;1242;261;0;1189.0;8626511
2021-04-07;1555;426;0;313.0;8628066
2021-04-07;2;0;0;-1553.0;8628068
2021-04-07;12440;19036;0;12438.0;8640508
2021-04-07;32675;7850;0;20235.0;8673183
2021-04-07;6337;1635;0;-26338.0;8679520
2021-04-07;7;3;0;-6330.0;8679527
2021-04-07;109720;53591;0;109713.0;8789247
2021-04-07;3941;1076;0;-105779.0;8793188
2021-04-07;11258;2462;0;7317.0;8804446
2021-04-07;9340;13378;0;-1918.0;8813786
2021-04-07;1;0;0;-9339.0;8813787
2021-04-07;15491;3282;0;15490.0;8829278
2021-04-07;15095;4061;0;-396.0;8844373
2021-04-07;1513;359;0;-13582.0;8845886
2021-04-07;65;23;0;-1448.0;8845951
2021-04-08;1920;412;0;1855.0;8847871
2021-04-08;8038;1948;0;6118.0;8855909
2021-04-08;4;1;0;-8034.0;8855913
2021-04-08;20662;3892;0;20658.0;8876575
2021-04-08;1958;560;0;-18704.0;8878533
2021-04-08;3;0;0;-1955.0;8878536
2021-04-08;5266;1319;0;5263.0;8883802
2021-04-08;143735;57936;0;138469.0;9027537
2021-04-08;14573;19397;0;-129162.0;9042110
2021-04-08;23118;4631;0;8545.0;9065228
2021-04-08;40027;9378;0;16909.0;9105255
2021-04-08;14;1;0;-40013.0;9105269
2021-04-08;59;17;0;45.0;9105328
2021-04-08;16870;2925;0;16811.0;9122198
2021-04-08;11223;13455;0;-5647.0;9133421
2021-04-09;181748;56458;0;170525.0;9315169
2021-04-09;34160;5018;0;-147588.0;9349329
2021-04-09;12171;12574;0;-21989.0;9361500
2021-04-09;71;18;0;-12100.0;9361571
2021-04-09;5434;1326;0;5363.0;9367005
2021-04-09;5;1;0;-5429.0;9367010
2021-04-09;8548;2030;0;8543.0;9375558
2021-04-09;2;1;0;-8546.0;9375560
2021-04-09;1802;425;0;1800.0;9377362
2021-04-09;15939;18030;0;14137.0;9393301
2021-04-09;45625;8717;0;29686.0;9438926
2021-04-09;1964;470;0;-43661.0;9440890
2021-04-09;29286;4486;0;27322.0;9470176
2021-04-09;26737;3361;0;-2549.0;9496913
2021-04-09;4;1;0;-26733.0;9496917
2021-04-10;22541;6775;0;22537.0;9519458
2021-04-10;33;11;0;-22508.0;9519491
2021-04-10;7369;11397;0;7336.0;9526860
2021-04-10;4;0;0;-7365.0;9526864
2021-04-10;2820;797;0;2816.0;9529684
2021-04-10;1006;266;0;-1814.0;9530690
2021-04-10;5204;1435;0;4198.0;9535894
2021-04-10;14862;2631;0;9658.0;9550756
2021-04-10;6116;8341;0;-8746.0;9556872
2021-04-10;3;0;0;-6113.0;9556875
2021-04-10;2;1;0;-1.0;9556877
2021-04-10;96795;39291;0;96793.0;9653672
2021-04-10;17733;3891;0;-79062.0;9671405
2021-04-10;1005;245;0;-16728.0;9672410
2021-04-10;18097;3501;0;17092.0;9690507
2021-04-11;497;135;0;-17600.0;9691004
2021-04-11;5664;3110;0;5167.0;9696668
2021-04-11;24863;15909;0;19199.0;9721531
2021-04-11;4822;1728;0;-20041.0;9726353
2021-04-11;6;0;0;-4816.0;9726359
2021-04-11;1767;3492;0;1761.0;9728126
2021-04-11;3669;2010;0;1902.0;9731795
2021-04-11;1296;429;0;-2373.0;9733091
2021-04-11;489;153;0;-807.0;9733580
2021-04-11;2047;800;0;1558.0;9735627
2021-04-11;2;0;0;-2045.0;9735629
2021-04-11;3000;1254;0;2998.0;9738629
2021-04-11;1590;2790;0;-1410.0;9740219
2021-04-11;0;0;0;-1590.0;9740219
2021-04-11;14;8;0;14.0;9740233
2021-04-12;3446;989;0;3432.0;9743679
2021-04-12;18285;4545;0;14839.0;9761964
2021-04-12;104528;53806;0;86243.0;9866492
2021-04-12;13707;2699;0;-90821.0;9880199
2021-04-12;4;0;0;-13703.0;9880203
2021-04-12;7478;13032;0;7474.0;9887681
2021-04-12;27956;8629;0;20478.0;9915637
2021-04-12;0;0;0;-27956.0;9915637
2021-04-12;1233;394;0;1233.0;9916870
2021-04-12;16859;3529;0;15626.0;9933729
2021-04-12;35;14;0;-16824.0;9933764
2021-04-12;5597;1539;0;5562.0;9939361
2021-04-12;8738;18085;0;3141.0;9948099
2021-04-12;1190;350;0;-7548.0;9949289
2021-04-12;0;1;0;-1190.0;9949289
2021-04-13;20910;3772;0;20910.0;9970199
2021-04-13;8;0;0;-20902.0;9970207
2021-04-13;1491;397;0;1483.0;9971698
2021-04-13;2;1;0;-1489.0;9971700
2021-04-13;32113;10383;0;32111.0;10003813
2021-04-13;11067;21467;0;-21046.0;10014880
2021-04-13;8579;15554;0;-2488.0;10023459
2021-04-13;1665;565;0;-6914.0;10025124
2021-04-13;1;0;0;-1664.0;10025125
2021-04-13;25676;6259;0;25675.0;10050801
2021-04-13;4470;1506;0;-21206.0;10055271
2021-04-13;137155;66844;0;132685.0;10192426
2021-04-13;7120;2153;0;-130035.0;10199546
2021-04-13;23999;4766;0;16879.0;10223545
2021-04-13;54;21;0;-23945.0;10223599
2021-04-14;5;0;0;-49.0;10223604
2021-04-14;1679;556;0;1674.0;10225283
2021-04-14;4555;1480;0;2876.0;10229838
2021-04-14;10;2;0;-4545.0;10229848
2021-04-14;8120;14703;0;8110.0;10237968
2021-04-14;10372;20372;0;2252.0;10248340
2021-04-14;1702;485;0;-8670.0;10250042
2021-04-14;7400;2223;0;5698.0;10257442
2021-04-14;1;0;0;-7399.0;10257443
2021-04-14;27674;10508;0;27673.0;10285117
2021-04-14;23101;6012;0;-4573.0;10308218
2021-04-14;128256;64672;0;105155.0;10436474
2021-04-14;58;15;0;-128198.0;10436532
2021-04-14;23849;4673;0;23791.0;10460381
2021-04-14;19730;3643;0;-4119.0;10480111
2021-04-15;1667;565;0;-18063.0;10481778
2021-04-15;25292;4254;0;23625.0;10507070
2021-04-15;29099;7115;0;3807.0;10536169
2021-04-15;148094;70237;0;118995.0;10684263
2021-04-15;3;0;0;-148091.0;10684266
2021-04-15;28597;5689;0;28594.0;10712863
2021-04-15;8472;15184;0;-20125.0;10721335
2021-04-15;7825;2697;0;-647.0;10729160
2021-04-15;28802;11425;0;20977.0;10757962
2021-04-15;5100;1732;0;-23702.0;10763062
2021-04-15;1879;651;0;-3221.0;10764941
2021-04-15;11281;20911;0;9402.0;10776222
2021-04-15;3;1;0;-11278.0;10776225
2021-04-15;5;0;0;2.0;10776230
2021-04-15;69;13;0;64.0;10776299
2021-04-16;6911;2796;0;6842.0;10783210
2021-04-16;33676;7172;0;26765.0;10816886
2021-04-16;151509;67831;0;117833.0;10968395
2021-04-16;24447;11393;0;-127062.0;10992842
2021-04-16;1;0;0;-24446.0;10992843
2021-04-16;4406;1842;0;4405.0;10997249
2021-04-16;7198;13742;0;2792.0;11004447
2021-04-16;56;16;0;-7142.0;11004503
2021-04-16;7;2;0;-49.0;11004510
2021-04-16;9658;19221;0;9651.0;11014168
2021-04-16;1550;578;0;-8108.0;11015718
2021-04-16;1557;650;0;7.0;11017275
2021-04-16;4;0;0;-1553.0;11017279
2021-04-16;30851;4512;0;30847.0;11048130
2021-04-16;31186;5907;0;335.0;11079316
2021-04-17;2408;1025;0;-28778.0;11081724
2021-04-17;84610;41416;0;82202.0;11166334
2021-04-17;18102;3552;0;-66508.0;11184436
2021-04-17;20056;4652;0;1954.0;11204492
2021-04-17;825;334;0;-19231.0;11205317
2021-04-17;18305;5133;0;17480.0;11223622
2021-04-17;38;22;0;-18267.0;11223660
2021-04-17;1;1;0;-37.0;11223661
2021-04-17;3495;7013;0;3494.0;11227156
2021-04-17;4;0;0;-3491.0;11227160
2021-04-17;755;310;0;751.0;11227915
2021-04-17;0;1;0;-755.0;11227915
2021-04-17;4173;1897;0;4173.0;11232088
2021-04-17;4461;9707;0;288.0;11236549
2021-04-17;11987;7769;0;7526.0;11248536
2021-04-18;951;2910;0;-11036.0;11249487
2021-04-18;1;0;0;-950.0;11249488
2021-04-18;5118;1594;0;5117.0;11254606
2021-04-18;4;0;0;-5114.0;11254610
2021-04-18;973;606;0;969.0;11255583
2021-04-18;1569;932;0;596.0;11257152
2021-04-18;2613;3246;0;1044.0;11259765
2021-04-18;5855;2241;0;3242.0;11265620
2021-04-18;1;0;0;-5854.0;11265621
2021-04-18;23159;16294;0;23158.0;11288780
2021-04-18;19;2;0;-23140.0;11288799
2021-04-18;800;2024;0;781.0;11289599
2021-04-18;304;164;0;-496.0;11289903
2021-04-18;328;210;0;24.0;11290231
2021-04-18;4623;2365;0;4295.0;11294854
2021-04-19;1054;495;0;-3569.0;11295908
2021-04-19;15515;5226;0;14461.0;11311423
2021-04-19;1060;619;0;-14455.0;11312483
2021-04-19;4935;2394;0;3875.0;11317418
2021-04-19;3;0;0;-4932.0;11317421
2021-04-19;89335;62382;0;89332.0;11406756
2021-04-19;5216;16913;0;-84119.0;11411972
2021-04-19;2982;1568;0;-2234.0;11414954
2021-04-19;19294;4207;0;16312.0;11434248
2021-04-19;14570;11216;0;-4724.0;11448818
2021-04-19;7;1;0;-14563.0;11448825
2021-04-19;5;0;0;-2.0;11448830
2021-04-19;4258;12944;0;4253.0;11453088
2021-04-19;20404;6790;0;16146.0;11473492
2021-04-19;32;9;0;-20372.0;11473524
2021-04-20;43;21;0;11.0;11473567
2021-04-20;16857;13889;0;16814.0;11490424
2021-04-20;5095;15343;0;-11762.0;11495519
2021-04-20;1100;649;0;-3995.0;11496619
2021-04-20;1293;856;0;193.0;11497912
2021-04-20;26026;8279;0;24733.0;11523938
2021-04-20;3643;2175;0;-22383.0;11527581
2021-04-20;6504;20501;0;2861.0;11534085
2021-04-20;5851;3193;0;-653.0;11539936
2021-04-20;2;0;0;-5849.0;11539938
2021-04-20;112600;76828;0;112598.0;11652538
2021-04-20;21458;6733;0;-91142.0;11673996
2021-04-20;1;1;0;-21457.0;11673997
2021-04-20;8;1;0;7.0;11674005
2021-04-20;24719;5187;0;24711.0;11698724
2021-04-21;4956;13584;0;-19763.0;11703680
2021-04-21;12;2;0;-4944.0;11703692
2021-04-21;1;0;0;-11.0;11703693
2021-04-21;56;27;0;55.0;11703749
2021-04-21;24558;5284;0;24502.0;11728307
2021-04-21;111164;74642;0;86606.0;11839471
2021-04-21;1276;724;0;-109888.0;11840747
2021-04-21;24365;8104;0;23089.0;11865112
2021-04-21;6570;3538;0;-17795.0;11871682
2021-04-21;3885;2332;0;-2685.0;11875567
2021-04-21;15470;13828;0;11585.0;11891037
2021-04-21;1315;897;0;-14155.0;11892352
2021-04-21;3;0;0;-1312.0;11892355
2021-04-21;6387;19144;0;6384.0;11898742
2021-04-21;22310;7178;0;15923.0;11921052
2021-04-22;58;17;0;-22252.0;11921110
2021-04-22;1665;1182;0;1607.0;11922775
2021-04-22;1423;824;0;-242.0;11924198
2021-04-22;26838;8747;0;25415.0;11951036
2021-04-22;17739;15904;0;-9099.0;11968775
2021-04-22;5733;13821;0;-12006.0;11974508
2021-04-22;127435;82650;0;121702.0;12101943
2021-04-22;27090;6107;0;-100345.0;12129033
2021-04-22;7415;19347;0;-19675.0;12136448
2021-04-22;3;0;0;-7412.0;12136451
2021-04-22;7338;4498;0;7335.0;12143789
2021-04-22;27609;9046;0;20271.0;12171398
2021-04-22;4508;3155;0;-23101.0;12175906
2021-04-22;4;0;0;-4504.0;12175910
2021-04-22;12;2;0;8.0;12175922
2021-04-23;5283;12155;0;5271.0;12181205
2021-04-23;23;10;0;-5260.0;12181228
2021-04-23;7872;5089;0;7849.0;12189100
2021-04-23;29061;6252;0;21189.0;12218161
2021-04-23;1875;1354;0;-27186.0;12220036
2021-04-23;58;32;0;-1817.0;12220094
2021-04-23;133405;82569;0;133347.0;12353499
2021-04-23;27578;9016;0;-105827.0;12381077
2021-04-23;16190;17420;0;-11388.0;12397267
2021-04-23;6750;16819;0;-9440.0;12404017
2021-04-23;4;0;0;-6746.0;12404021
2021-04-23;1687;1152;0;1683.0;12405708
2021-04-23;32065;9656;0;30378.0;12437773
2021-04-23;4959;3614;0;-27106.0;12442732
2021-04-23;0;0;0;-4959.0;12442732
2021-04-24;86564;51494;0;86564.0;12529296
2021-04-24;2;0;0;-86562.0;12529298
2021-04-24;1010;611;0;1008.0;12530308
2021-04-24;20471;4487;0;19461.0;12550779
2021-04-24;3186;1916;0;-17285.0;12553965
2021-04-24;8717;13245;0;5531.0;12562682
2021-04-24;1094;658;0;-7623.0;12563776
2021-04-24;6;0;0;-1088.0;12563782
2021-04-24;2639;5934;0;2633.0;12566421
2021-04-24;5516;3149;0;2877.0;12571937
2021-04-24;38;18;0;-5478.0;12571975
2021-04-24;3373;8005;0;3335.0;12575348
2021-04-24;3;2;0;-3370.0;12575351
2021-04-24;23000;7495;0;22997.0;12598351
2021-04-24;17509;5974;0;-5491.0;12615860
2021-04-25;7855;2607;0;-9654.0;12623715
2021-04-25;523;318;0;-7332.0;12624238
2021-04-25;2877;5497;0;2354.0;12627115
2021-04-25;2;0;0;-2875.0;12627117
2021-04-25;3;0;0;1.0;12627120
2021-04-25;1480;799;0;1477.0;12628600
2021-04-25;522;306;0;-958.0;12629122
2021-04-25;0;0;0;-522.0;12629122
2021-04-25;31461;18035;0;31461.0;12660583
2021-04-25;7714;1608;0;-23747.0;12668297
2021-04-25;29;4;0;-7685.0;12668326
2021-04-25;6101;2225;0;6072.0;12674427
2021-04-25;968;1926;0;-5133.0;12675395
2021-04-25;856;1458;0;-112.0;12676251
2021-04-25;2531;1287;0;1675.0;12678782
2021-04-26;22406;8550;0;19875.0;12701188
2021-04-26;3304;2339;0;-19102.0;12704492
2021-04-26;1;0;0;-3303.0;12704493
2021-04-26;20017;8063;0;20016.0;12724510
2021-04-26;36;10;0;-19981.0;12724546
2021-04-26;5958;3557;0;5922.0;12730504
2021-04-26;3986;9207;0;-1972.0;12734490
2021-04-26;10;1;0;-3976.0;12734500
2021-04-26;23459;5652;0;23449.0;12757959
2021-04-26;1233;856;0;-22226.0;12759192
2021-04-26;98492;71675;0;97259.0;12857684
2021-04-26;1;0;0;-98491.0;12857685
2021-04-26;1162;716;0;1161.0;12858847
2021-04-26;12399;20845;0;11237.0;12871246
2021-04-26;4520;11879;0;-7879.0;12875766
2021-04-27;1574;1223;0;-2946.0;12877340
2021-04-27;4526;3038;0;2952.0;12881866
2021-04-27;3;0;0;-4523.0;12881869
2021-04-27;8092;4537;0;8089.0;12889961
2021-04-27;34;20;0;-8058.0;12889995
2021-04-27;13;3;0;-21.0;12890008
2021-04-27;29854;7620;0;29841.0;12919862
2021-04-27;1463;964;0;-28391.0;12921325
2021-04-27;28171;10744;0;26708.0;12949496
2021-04-27;3;0;0;-28168.0;12949499
2021-04-27;15329;24627;0;15326.0;12964828
2021-04-27;127546;87878;0;112217.0;13092374
2021-04-27;5994;13894;0;-121552.0;13098368
2021-04-27;4914;10585;0;-1080.0;13103282
2021-04-27;27576;10623;0;22662.0;13130858
2021-04-28;9462;5100;0;-18114.0;13140320
2021-04-28;5113;9156;0;-4349.0;13145433
2021-04-28;29831;7685;0;24718.0;13175264
2021-04-28;1;1;0;-29830.0;13175265
2021-04-28;132462;86049;1;132461.0;13307727
2021-04-28;27661;10360;0;-104801.0;13335388
2021-04-28;6318;13004;0;-21343.0;13341706
2021-04-28;5113;3249;0;-1205.0;13346819
2021-04-28;1729;1137;0;-3384.0;13348548
2021-04-28;1795;1366;0;66.0;13350343
2021-04-28;12;4;0;-1783.0;13350355
2021-04-28;30041;11538;0;30029.0;13380396
2021-04-28;72;23;0;-29969.0;13380468
2021-04-28;15312;23425;1;15240.0;13395780
2021-04-28;2;1;0;-15310.0;13395782
2021-04-29;67;21;0;65.0;13395849
2021-04-29;32370;11616;0;32303.0;13428219
2021-04-29;2122;1373;0;-30248.0;13430341
2021-04-29;0;0;0;-2122.0;13430341
2021-04-29;2389;1617;0;2389.0;13432730
2021-04-29;7602;13128;0;5213.0;13440332
2021-04-29;35004;10351;0;27402.0;13475336
2021-04-29;5985;9147;0;-29019.0;13481321
2021-04-29;0;0;0;-5985.0;13481321
2021-04-29;160782;96075;0;160782.0;13642103
2021-04-29;10;1;0;-160772.0;13642113
2021-04-29;6849;3962;0;6839.0;13648962
2021-04-29;38114;14804;0;31265.0;13687076
2021-04-29;12230;6098;0;-25884.0;13699306
2021-04-29;18040;23957;0;5810.0;13717346
2021-04-30;168862;94218;0;150822.0;13886208
2021-04-30;30950;11183;0;-137912.0;13917158
2021-04-30;1;0;0;-30949.0;13917159
2021-04-30;2423;1401;0;2422.0;13919582
2021-04-30;35981;11173;0;33558.0;13955563
2021-04-30;45745;17501;0;9764.0;14001308
2021-04-30;16330;21887;0;-29415.0;14017638
2021-04-30;7162;10743;0;-9168.0;14024800
2021-04-30;7863;4314;0;701.0;14032663
2021-04-30;2516;1676;0;-5347.0;14035179
2021-04-30;3;1;0;-2513.0;14035182
2021-04-30;84;30;0;81.0;14035266
2021-04-30;7;2;0;-77.0;14035273
2021-04-30;5671;7714;0;5664.0;14040944
2021-04-30;14126;6593;0;8455.0;14055070
2021-05-01;6249;1382;0;-7877.0;14061319
2021-05-01;11095;3577;0;4846.0;14072414
2021-05-01;9;0;0;-11086.0;14072423
2021-05-01;12;0;0;3.0;14072435
2021-05-01;1854;408;0;1842.0;14074289
2021-05-01;76425;27656;0;74571.0;14150714
2021-05-01;1;0;0;-76424.0;14150715
2021-05-01;71;9;0;70.0;14150786
2021-05-01;11428;2493;0;11357.0;14162214
2021-05-01;13859;3281;0;2431.0;14176073
2021-05-01;2001;464;0;-11858.0;14178074
2021-05-01;1667;1727;0;-334.0;14179741
2021-05-01;21079;5439;0;19412.0;14200820
2021-05-01;1998;2124;0;-19081.0;14202818
2021-05-01;5102;6752;0;3104.0;14207920
2021-05-02;44;12;0;-5058.0;14207964
2021-05-02;6872;1913;0;6828.0;14214836
2021-05-02;2;0;0;-6870.0;14214838
2021-05-02;8022;1675;0;8020.0;14222860
2021-05-02;759;1152;0;-7263.0;14223619
2021-05-02;1;0;0;-758.0;14223620
2021-05-02;42547;18810;0;42546.0;14266167
2021-05-02;5183;2331;0;-37364.0;14271350
2021-05-02;1316;331;0;-3867.0;14272666
2021-05-02;11381;3580;0;10065.0;14284047
2021-05-02;2428;5098;0;-8953.0;14286475
2021-05-02;3;0;0;-2425.0;14286478
2021-05-02;1245;354;0;1242.0;14287723
2021-05-02;904;1405;0;-341.0;14288627
2021-05-02;4387;959;0;3483.0;14293014
2021-05-03;11119;22830;0;6732.0;14304133
2021-05-03;103;25;0;-11016.0;14304236
2021-05-03;24887;7465;0;24784.0;14329123
2021-05-03;4497;7761;0;-20390.0;14333620
2021-05-03;3814;6633;0;-683.0;14337434
2021-05-03;9;0;0;-3805.0;14337443
2021-05-03;30831;12120;0;30822.0;14368274
2021-05-03;19996;5874;0;-10835.0;14388270
2021-05-03;134094;78918;0;114098.0;14522364
2021-05-03;2929;1391;0;-131165.0;14525293
2021-05-03;5;3;0;-2924.0;14525298
2021-05-03;3;0;0;-2.0;14525301
2021-05-03;10756;3937;0;10753.0;14536057
2021-05-03;3315;1498;0;-7441.0;14539372
2021-05-03;21830;9381;0;18515.0;14561202
2021-05-04;3984;8915;0;-17846.0;14565186
2021-05-04;25543;10644;0;21559.0;14590729
2021-05-04;22394;12773;0;-3149.0;14613123
2021-05-04;11715;30863;0;-10679.0;14624838
2021-05-04;79;43;0;-11636.0;14624917
2021-05-04;16;7;0;-63.0;14624933
2021-05-04;35088;16047;0;35072.0;14660021
2021-05-04;4775;10983;0;-30313.0;14664796
2021-05-04;3836;1886;0;-939.0;14668632
2021-05-04;4;3;0;-3832.0;14668636
2021-05-04;3388;1620;0;3384.0;14672024
2021-05-04;3;4;0;-3385.0;14672027
2021-05-04;23275;7798;0;23272.0;14695302
2021-05-04;146810;106451;0;123535.0;14842112
2021-05-04;12710;4865;0;-134100.0;14854822
2021-05-05;36582;16917;0;23872.0;14891404
2021-05-05;19944;12523;0;-16638.0;14911348
2021-05-05;25755;7968;0;5811.0;14937103
2021-05-05;18;2;0;-25737.0;14937121
2021-05-05;147778;105402;0;147760.0;15084899
2021-05-05;3655;8333;0;-144123.0;15088554
2021-05-05;4774;10815;0;1119.0;15093328
2021-05-05;8;1;0;-4766.0;15093336
2021-05-05;14329;4994;0;14321.0;15107665
2021-05-05;110;34;0;-14219.0;15107775
2021-05-05;6;1;0;-104.0;15107781
2021-05-05;4058;1657;0;4052.0;15111839
2021-05-05;23535;11224;0;19477.0;15135374
2021-05-05;10533;29063;0;-13002.0;15145907
2021-05-05;4471;1870;0;-6062.0;15150378
2021-05-06;30959;9332;0;26488.0;15181337
2021-05-06;12890;28425;0;-18069.0;15194227
2021-05-06;5494;10717;0;-7396.0;15199721
2021-05-06;177236;116293;0;171742.0;15376957
2021-05-06;44705;20388;0;-132531.0;15421662
2021-05-06;4916;2075;0;-39789.0;15426578
2021-05-06;5176;2261;0;260.0;15431754
2021-05-06;122;51;0;-5054.0;15431876
2021-05-06;27408;14601;0;27286.0;15459284
2021-05-06;16;7;0;-27392.0;15459300
2021-05-06;5;1;0;-11.0;15459305
2021-05-06;17225;5918;0;17220.0;15476530
2021-05-06;4528;8437;0;-12697.0;15481058
2021-05-06;5;3;0;-4523.0;15481063
2021-05-06;23787;14077;0;23782.0;15504850
2021-05-07;5285;2103;0;-18502.0;15510135
2021-05-07;139;37;0;-5146.0;15510274
2021-05-07;5297;2067;0;5158.0;15515571
2021-05-07;4;1;0;-5293.0;15515575
2021-05-07;17957;6333;0;17953.0;15533532
2021-05-07;31997;9899;0;14040.0;15565529
2021-05-07;10;0;0;-31987.0;15565539
2021-05-07;5161;10675;0;5151.0;15570700
2021-05-07;175561;129108;0;170400.0;15746261
2021-05-07;3888;8597;0;-171673.0;15750149
2021-05-07;24890;17305;0;21002.0;15775039
2021-05-07;10927;29975;0;-13963.0;15785966
2021-05-07;49717;26111;0;38790.0;15835683
2021-05-07;14;3;0;-49703.0;15835697
2021-05-07;20275;16002;0;20261.0;15855972
2021-05-08;1647;2470;0;-18628.0;15857619
2021-05-08;4988;946;0;3341.0;15862607
2021-05-08;4402;901;0;-586.0;15867009
2021-05-08;103788;38573;0;99386.0;15970797
2021-05-08;25501;4145;0;-78287.0;15996298
2021-05-08;7484;4876;0;-18017.0;16003782
2021-05-08;14190;2319;0;6706.0;16017972
2021-05-08;3;2;0;-14187.0;16017975
2021-05-08;30124;8546;0;30121.0;16048099
2021-05-08;3874;7364;0;-26250.0;16051973
2021-05-08;5;0;0;-3869.0;16051978
2021-05-08;19;0;0;14.0;16051997
2021-05-08;186;21;0;167.0;16052183
2021-05-08;1321;2064;0;1135.0;16053504
2021-05-08;10044;4919;0;8723.0;16063548
2021-05-09;0;0;0;-10044.0;16063548
2021-05-09;1743;4461;0;1743.0;16065291
2021-05-09;3226;732;0;1483.0;16068517
2021-05-09;2837;697;0;-389.0;16071354
2021-05-09;2;1;0;-2835.0;16071356
2021-05-09;3;0;0;1.0;16071359
2021-05-09;3418;2840;0;3415.0;16074777
2021-05-09;681;1375;0;-2737.0;16075458
2021-05-09;9017;1793;0;8336.0;16084475
2021-05-09;20052;4981;0;11035.0;16104527
2021-05-09;15887;2708;0;-4165.0;16120414
2021-05-09;600;1292;0;-15287.0;16121014
2021-05-09;62472;23466;0;61872.0;16183486
2021-05-09;4879;2575;0;-57593.0;16188365
2021-05-09;127;11;0;-4752.0;16188492
2021-05-10;150668;110074;0;150541.0;16339160
2021-05-10;16750;5224;0;-133918.0;16355910
2021-05-10;3249;8871;0;-13501.0;16359159
2021-05-10;49653;19082;0;46404.0;16408812
2021-05-10;5322;1884;0;-44331.0;16414134
2021-05-10;13;3;0;-5309.0;16414147
2021-05-10;6;0;0;-7.0;16414153
2021-05-10;7;0;0;1.0;16414160
2021-05-10;28989;8108;0;28982.0;16443149
2021-05-10;234;22;0;-28755.0;16443383
2021-05-10;16926;12965;0;16692.0;16460309
2021-05-10;7540;28594;0;-9386.0;16467849
2021-05-10;2699;7679;0;-4841.0;16470548
2021-05-10;13962;15914;0;11263.0;16484510
2021-05-10;5318;1728;0;-8644.0;16489828
2021-05-11;196276;129165;0;190958.0;16686104
2021-05-11;35961;9240;0;-160315.0;16722065
2021-05-11;4386;10023;0;-31575.0;16726451
2021-05-11;19;2;0;-4367.0;16726470
2021-05-11;21791;6172;0;21772.0;16748261
2021-05-11;65871;23752;0;44080.0;16814132
2021-05-11;8;0;0;-65863.0;16814140
2021-05-11;253;28;0;245.0;16814393
2021-05-11;21834;17808;0;21581.0;16836227
2021-05-11;18087;20139;0;-3747.0;16854314
2021-05-11;7181;2356;0;-10906.0;16861495
2021-05-11;9902;29249;0;2721.0;16871397
2021-05-11;6;2;0;-9896.0;16871403
2021-05-11;3521;8272;0;3515.0;16874924
2021-05-11;7456;2122;0;3935.0;16882380
2021-05-12;393;48;0;-7063.0;16882773
2021-05-12;4072;8542;0;3679.0;16886845
2021-05-12;42772;9250;0;38700.0;16929617
2021-05-12;28;3;0;-42744.0;16929645
2021-05-12;11096;2343;0;11068.0;16940741
2021-05-12;9;0;0;-11087.0;16940750
2021-05-12;19034;16839;0;19025.0;16959784
2021-05-12;27958;6079;0;8924.0;16987742
2021-05-12;12;0;0;-27946.0;16987754
2021-05-12;15628;18127;0;15616.0;17003382
2021-05-12;3181;6977;0;-12447.0;17006563
2021-05-12;8558;24244;0;5377.0;17015121
2021-05-12;10220;2423;0;1662.0;17025341
2021-05-12;61371;21602;0;51151.0;17086712
2021-05-12;204332;116477;0;142961.0;17291044
2021-05-13;3;0;0;-204329.0;17291047
2021-05-13;434;37;0;431.0;17291481
2021-05-13;8073;5259;0;7639.0;17299554
2021-05-13;47496;7219;0;39423.0;17347050
2021-05-13;13623;1424;0;-33873.0;17360673
2021-05-13;165956;35085;0;152333.0;17526629
2021-05-13;3;0;0;-165953.0;17526632
2021-05-13;40647;3665;0;40644.0;17567279
2021-05-13;24;2;0;-40623.0;17567303
2021-05-13;27245;2548;0;27221.0;17594548
2021-05-13;4239;5597;0;-23006.0;17598787
2021-05-13;1572;1636;0;-2667.0;17600359
2021-05-13;10144;1081;0;8572.0;17610503
2021-05-13;10719;4665;0;575.0;17621222
2021-05-13;1734;1952;0;-8985.0;17622956
2021-05-14;2;0;0;-1732.0;17622958
2021-05-14;3689;6131;0;3687.0;17626647
2021-05-14;31780;4530;0;28091.0;17658427
2021-05-14;33;5;0;-31747.0;17658460
2021-05-14;67028;17066;0;66995.0;17725488
2021-05-14;472;40;0;-66556.0;17725960
2021-05-14;14;1;0;-458.0;17725974
2021-05-14;13900;15469;0;13886.0;17739874
2021-05-14;15704;2150;0;1804.0;17755578
2021-05-14;221308;90404;0;205604.0;17976886
2021-05-14;48858;6809;0;-172450.0;18025744
2021-05-14;17572;13987;0;-31286.0;18043316
2021-05-14;3038;4989;0;-14534.0;18046354
2021-05-14;7844;17438;0;4806.0;18054198
2021-05-14;11374;1789;0;3530.0;18065572
2021-05-15;1416;2166;0;-9958.0;18066988
2021-05-15;3910;8229;0;2494.0;18070898
2021-05-15;24;0;0;-3886.0;18070922
2021-05-15;4;1;0;-20.0;18070926
2021-05-15;10967;1358;0;10963.0;18081893
2021-05-15;10489;9417;0;-478.0;18092382
2021-05-15;59654;13071;0;49165.0;18152036
2021-05-15;1742;2732;0;-57912.0;18153778
2021-05-15;7168;8553;0;5426.0;18160946
2021-05-15;43390;5007;0;36222.0;18204336
2021-05-15;4;1;0;-43386.0;18204340
2021-05-15;537;39;0;533.0;18204877
2021-05-15;16952;1773;0;16415.0;18221829
2021-05-15;28883;3160;0;11931.0;18250712
2021-05-15;185140;55507;0;156257.0;18435852
2021-05-16;1360;1590;0;-183780.0;18437212
2021-05-16;29079;3657;0;27719.0;18466291
2021-05-16;27065;2226;0;-2014.0;18493356
2021-05-16;505;512;0;-26560.0;18493861
2021-05-16;101052;15709;0;100547.0;18594913
2021-05-16;547;535;0;-100505.0;18595460
2021-05-16;10614;968;0;10067.0;18606074
2021-05-16;1;0;0;-10613.0;18606075
2021-05-16;3941;2014;0;3940.0;18610016
2021-05-16;2509;1955;0;-1432.0;18612525
2021-05-16;4;1;0;-2505.0;18612529
2021-05-16;6718;667;0;6714.0;18619247
2021-05-16;18421;1562;0;11703.0;18637668
2021-05-16;6;1;0;-18415.0;18637674
2021-05-16;282;21;0;276.0;18637956
2021-05-17;10184;13050;0;9902.0;18648140
2021-05-17;54787;14818;0;44603.0;18702927
2021-05-17;5;0;0;-54782.0;18702932
2021-05-17;2249;3965;0;2244.0;18705181
2021-05-17;28323;4738;0;26074.0;18733504
2021-05-17;13687;2072;0;-14636.0;18747191
2021-05-17;10747;2009;0;-2940.0;18757938
2021-05-17;183241;78246;0;172494.0;18941179
2021-05-17;41633;6831;0;-141608.0;18982812
2021-05-17;2535;4747;0;-39098.0;18985347
2021-05-17;6;0;0;-2529.0;18985353
2021-05-17;5651;13982;0;5645.0;18991004
2021-05-17;315;25;0;-5336.0;18991319
2021-05-17;13110;12007;0;12795.0;19004429
2021-05-17;9;2;0;-13101.0;19004438
2021-05-18;10;1;0;1.0;19004448
2021-05-18;36170;5494;0;36160.0;19040618
2021-05-18;7261;14267;0;-28909.0;19047879
2021-05-18;31;7;0;-7230.0;19047910
2021-05-18;16611;13967;0;16580.0;19064521
2021-05-18;61625;16730;0;45014.0;19126146
2021-05-18;369;26;0;-61256.0;19126515
2021-05-18;50825;7464;0;50456.0;19177340
2021-05-18;5;2;0;-50820.0;19177345
2021-05-18;17706;2429;0;17701.0;19195051
2021-05-18;13341;13899;0;-4365.0;19208392
2021-05-18;2706;4097;0;-10635.0;19211098
2021-05-18;14358;2331;0;11652.0;19225456
2021-05-18;224344;85669;0;209986.0;19449800
2021-05-18;3326;4955;0;-221018.0;19453126
2021-05-19;58150;16572;0;54824.0;19511276
2021-05-19;13967;2463;0;-44183.0;19525243
2021-05-19;218042;79149;0;204075.0;19743285
2021-05-19;6568;11556;0;-211474.0;19749853
2021-05-19;11567;11653;0;4999.0;19761420
2021-05-19;35949;5594;0;24382.0;19797369
2021-05-19;14904;12837;0;-21045.0;19812273
2021-05-19;549;56;0;-14355.0;19812822
2021-05-19;52107;7857;0;51558.0;19864929
2021-05-19;4;1;0;-52103.0;19864933
2021-05-19;25;1;0;21.0;19864958
2021-05-19;3177;4332;0;3152.0;19868135
2021-05-19;6;2;0;-3171.0;19868141
2021-05-19;2556;3496;0;2550.0;19870697
2021-05-19;18513;2729;0;15957.0;19889210
2021-05-20;9;1;0;-18504.0;19889219
2021-05-20;16258;2638;0;16249.0;19905477
2021-05-20;246146;93171;0;229888.0;20151623
2021-05-20;7599;13208;0;-238547.0;20159222
2021-05-20;3678;4646;0;-3921.0;20162900
2021-05-20;21370;2997;0;17692.0;20184270
2021-05-20;41535;6042;0;20165.0;20225805
2021-05-20;4;1;0;-41531.0;20225809
2021-05-20;13360;13368;0;13356.0;20239169
2021-05-20;2904;3606;0;-10456.0;20242073
2021-05-20;509;42;0;-2395.0;20242582
2021-05-20;35;5;0;-474.0;20242617
2021-05-20;63777;21219;0;63742.0;20306394
2021-05-20;57860;8619;0;-5917.0;20364254
2021-05-20;17248;16779;0;-40612.0;20381502
2021-05-21;611;52;0;-16637.0;20382113
2021-05-21;8;0;0;-603.0;20382121
2021-05-21;10959;15013;0;10951.0;20393080
2021-05-21;22023;2954;0;11064.0;20415103
2021-05-21;15999;2587;0;-6024.0;20431102
2021-05-21;58148;8529;0;42149.0;20489250
2021-05-21;9;0;0;-58139.0;20489259
2021-05-21;15007;19308;0;14998.0;20504266
2021-05-21;3046;4686;0;-11961.0;20507312
2021-05-21;240648;102830;0;237602.0;20747960
2021-05-21;2463;3898;0;-238185.0;20750423
2021-05-21;41457;6065;0;38994.0;20791880
2021-05-21;6260;14845;0;-35197.0;20798140
2021-05-21;64632;24888;0;58372.0;20862772
2021-05-21;26;5;0;-64606.0;20862798
2021-05-22;1332;1939;0;1306.0;20864130
2021-05-22;12995;1409;0;11663.0;20877125
2021-05-22;21568;2052;0;8573.0;20898693
2021-05-22;14;0;0;-21554.0;20898707
2021-05-22;1031;1706;0;1017.0;20899738
2021-05-22;2;0;0;-1029.0;20899740
2021-05-22;43315;13197;0;43313.0;20943055
2021-05-22;171049;51537;0;127734.0;21114104
2021-05-22;7;1;0;-171042.0;21114111
2021-05-22;662;50;0;655.0;21114773
2021-05-22;31859;3373;0;31197.0;21146632
2021-05-22;43753;4934;0;11894.0;21190385
2021-05-22;7397;9172;0;-36356.0;21197782
2021-05-22;4438;7056;0;-2959.0;21202220
2021-05-22;2676;6648;0;-1762.0;21204896
2021-05-23;308;364;0;-2368.0;21205204
2021-05-23;842;1059;0;534.0;21206046
2021-05-23;11248;1117;0;10406.0;21217294
2021-05-23;21931;2027;0;10683.0;21239225
2021-05-23;7043;711;0;-14888.0;21246268
2021-05-23;16819;2669;0;9776.0;21263087
2021-05-23;80103;12454;0;63284.0;21343190
2021-05-23;1505;1109;0;-78598.0;21344695
2021-05-23;291;21;0;-1214.0;21344986
2021-05-23;2558;1312;0;2267.0;21347544
2021-05-23;368;438;0;-2190.0;21347912
2021-05-23;3;0;0;-365.0;21347915
2021-05-23;17173;1625;0;17170.0;21365088
2021-05-23;2;0;0;-17171.0;21365090
2021-05-23;12;2;0;10.0;21365102
2021-05-24;792;716;0;780.0;21365894
2021-05-24;4;0;0;-788.0;21365898
2021-05-24;19;1;0;15.0;21365917
2021-05-24;906;798;0;887.0;21366823
2021-05-24;33994;3290;0;33088.0;21400817
2021-05-24;27425;5070;0;-6569.0;21428242
2021-05-24;519;35;0;-26906.0;21428761
2021-05-24;5428;3037;0;4909.0;21434189
2021-05-24;2139;2721;0;-3289.0;21436328
2021-05-24;26429;2596;0;24290.0;21462757
2021-05-24;5;0;0;-26424.0;21462762
2021-05-24;3779;3268;0;3774.0;21466541
2021-05-24;128842;24439;0;125063.0;21595383
2021-05-24;11309;1264;0;-117533.0;21606692
2021-05-24;16094;1643;0;4785.0;21622786
2021-05-25;15431;2768;0;-663.0;21638217
2021-05-25;20725;2937;0;5294.0;21658942
2021-05-25;1968;4532;0;-18757.0;21660910
2021-05-25;9;0;0;-1959.0;21660919
2021-05-25;44403;20615;0;44394.0;21705322
2021-05-25;25;5;0;-44378.0;21705347
2021-05-25;11360;16890;0;11335.0;21716707
2021-05-25;5018;16781;0;-6342.0;21721725
2021-05-25;197106;101953;0;192088.0;21918831
2021-05-25;2357;5198;0;-194749.0;21921188
2021-05-25;8477;16896;0;6120.0;21929665
2021-05-25;541;54;0;-7936.0;21930206
2021-05-25;49180;8881;0;48639.0;21979386
2021-05-25;13;1;0;-49167.0;21979399
2021-05-25;37599;6395;0;37586.0;22016998
2021-05-26;1906;4356;0;-35693.0;22018904
2021-05-26;194274;102523;0;192368.0;22213178
2021-05-26;11;1;0;-194263.0;22213189
2021-05-26;2378;5286;0;2367.0;22215567
2021-05-26;41800;21173;0;39422.0;22257367
2021-05-26;15969;2729;0;-25831.0;22273336
2021-05-26;21712;3044;0;5743.0;22295048
2021-05-26;37848;6603;0;16136.0;22332896
2021-05-26;7851;16651;0;-29997.0;22340747
2021-05-26;6;0;0;-7845.0;22340753
2021-05-26;19;4;0;13.0;22340772
2021-05-26;776;79;0;757.0;22341548
2021-05-26;4713;16031;0;3937.0;22346261
2021-05-26;10644;17223;0;5931.0;22356905
2021-05-26;48641;9343;0;37997.0;22405546
2021-05-27;2904;6177;0;-45737.0;22408450
2021-05-27;12;2;0;-2892.0;22408462
2021-05-27;53305;10300;0;53293.0;22461767
2021-05-27;17788;3184;0;-35517.0;22479555
2021-05-27;13027;21574;0;-4761.0;22492582
2021-05-27;643;79;0;-12384.0;22493225
2021-05-27;24398;3401;0;23755.0;22517623
2021-05-27;47128;25994;0;22730.0;22564751
2021-05-27;26;4;0;-47102.0;22564777
2021-05-27;9784;20389;0;9758.0;22574561
2021-05-27;2330;5038;0;-7454.0;22576891
2021-05-27;219850;122517;0;217520.0;22796741
2021-05-27;5601;19133;0;-214249.0;22802342
2021-05-27;3;1;0;-5598.0;22802345
2021-05-27;42901;7241;0;42898.0;22845246
2021-05-28;213204;148997;0;170303.0;23058450
2021-05-28;13;2;0;-213191.0;23058463
2021-05-28;51736;11611;0;51723.0;23110199
2021-05-28;714;77;0;-51022.0;23110913
2021-05-28;2882;6745;0;2168.0;23113795
2021-05-28;48988;33658;0;46106.0;23162783
2021-05-28;2081;5723;0;-46907.0;23164864
2021-05-28;27;7;0;-2054.0;23164891
2021-05-28;12402;27962;0;12375.0;23177293
2021-05-28;5;1;0;-12397.0;23177298
2021-05-28;40106;7936;0;40101.0;23217404
2021-05-28;8893;26134;0;-31213.0;23226297
2021-05-28;23302;3678;0;14409.0;23249599
2021-05-28;5329;22243;0;-17973.0;23254928
2021-05-28;16726;3220;0;11397.0;23271654
2021-05-29;3716;15159;0;-13010.0;23275370
2021-05-29;21622;2669;0;17906.0;23296992
2021-05-29;889;3108;0;-20733.0;23297881
2021-05-29;32408;20275;0;31519.0;23330289
2021-05-29;1182;3377;0;-31226.0;23331471
2021-05-29;18;3;0;-1164.0;23331489
2021-05-29;29361;4593;0;29343.0;23360850
2021-05-29;6214;16778;0;-23147.0;23367064
2021-05-29;3;0;0;-6211.0;23367067
2021-05-29;2;0;0;-1.0;23367069
2021-05-29;37732;7188;0;37730.0;23404801
2021-05-29;2206;12008;0;-35526.0;23407007
2021-05-29;149568;87171;0;147362.0;23556575
2021-05-29;822;80;0;-148746.0;23557397
2021-05-29;13393;1933;0;12571.0;23570790
2021-05-30;1400;3513;0;-11993.0;23572190
2021-05-30;14156;2216;0;12756.0;23586346
2021-05-30;834;3277;0;-13322.0;23587180
2021-05-30;8;2;0;-826.0;23587188
2021-05-30;8750;3833;0;8742.0;23595938
2021-05-30;491;2064;0;-8259.0;23596429
2021-05-30;4;0;0;-487.0;23596433
2021-05-30;308;27;0;304.0;23596741
2021-05-30;8734;1032;0;8426.0;23605475
2021-05-30;2;0;0;-8732.0;23605477
2021-05-30;197;616;0;195.0;23605674
2021-05-30;53782;19691;0;53585.0;23659456
2021-05-30;225;573;0;-53557.0;23659681
2021-05-30;6027;804;0;5802.0;23665708
2021-05-30;12646;1734;0;6619.0;23678354
2021-05-31;7886;21666;0;-4760.0;23686240
2021-05-31;3546;14025;0;-4340.0;23689786
2021-05-31;45958;9412;0;42412.0;23735744
2021-05-31;30697;20540;0;-15261.0;23766441
2021-05-31;1729;4649;0;-28968.0;23768170
2021-05-31;5973;21767;0;4244.0;23774143
2021-05-31;579;66;0;-5394.0;23774722
2021-05-31;17345;2940;0;16766.0;23792067
2021-05-31;178827;109063;1;161482.0;23970894
2021-05-31;6;3;0;-178821.0;23970900
2021-05-31;1409;3984;0;1403.0;23972309
2021-05-31;7;2;0;-1402.0;23972316
2021-05-31;39016;6601;0;39009.0;24011332
2021-05-31;27;3;1;-38989.0;24011359
2021-05-31;24649;3405;0;24622.0;24036008
2021-06-01;20;2;0;-24629.0;24036028
2021-06-01;8010;27071;0;7990.0;24044038
2021-06-01;18;3;0;-7992.0;24044056
2021-06-01;29;7;0;11.0;24044085
2021-06-01;54307;11456;0;54278.0;24098392
2021-06-01;21324;3560;0;-32983.0;24119716
2021-06-01;4989;19445;0;-16335.0;24124705
2021-06-01;899;88;0;-4090.0;24125604
2021-06-01;1935;5086;0;1036.0;24127539
2021-06-01;47104;8063;0;45169.0;24174643
2021-06-01;36554;26368;0;-10550.0;24211197
2021-06-01;2605;6126;0;-33949.0;24213802
2021-06-01;10598;27069;0;7993.0;24224400
2021-06-01;29981;4101;1;19383.0;24254381
2021-06-01;218373;138445;1;188392.0;24472754
2021-06-02;46361;8187;0;-172012.0;24519115
2021-06-02;33;2;0;-46328.0;24519148
2021-06-02;4001;16626;0;3968.0;24523149
2021-06-02;22;4;0;-3979.0;24523171
2021-06-02;17;2;0;-5.0;24523188
2021-06-02;51554;11223;0;51537.0;24574742
2021-06-02;1709;4393;0;-49845.0;24576451
2021-06-02;1295;93;0;-414.0;24577746
2021-06-02;8626;24209;0;7331.0;24586372
2021-06-02;206002;126251;0;197376.0;24792374
2021-06-02;30570;4216;0;-175432.0;24822944
2021-06-02;6415;23717;0;-24155.0;24829359
2021-06-02;2198;5441;0;-4217.0;24831557
2021-06-02;32287;24746;0;30089.0;24863844
2021-06-02;20914;3392;0;-11373.0;24884758
2021-06-03;52688;9130;0;31774.0;24937446
2021-06-03;18;2;0;-52670.0;24937464
2021-06-03;2069;5062;0;2051.0;24939533
2021-06-03;36837;28532;0;34768.0;24976370
2021-06-03;58021;12249;0;21184.0;25034391
2021-06-03;25;9;0;-57996.0;25034416
2021-06-03;7787;27378;0;7762.0;25042203
2021-06-03;1165;125;0;-6622.0;25043368
2021-06-03;30;0;0;-1135.0;25043398
2021-06-03;2880;6153;0;2850.0;25046278
2021-06-03;23424;3768;0;20544.0;25069702
2021-06-03;33662;4380;0;10238.0;25103364
2021-06-03;4983;20685;0;-28679.0;25108347
2021-06-03;10686;26338;0;5703.0;25119033
2021-06-03;234275;143811;0;223589.0;25353308
2021-06-04;233693;168913;1;-582.0;25587001
2021-06-04;1332;140;0;-232361.0;25588333
2021-06-04;33509;4639;0;32177.0;25621842
2021-06-04;1855;5759;0;-31654.0;25623697
2021-06-04;58892;13849;0;57037.0;25682589
2021-06-04;4490;23719;0;-54402.0;25687079
2021-06-04;8;0;0;-4482.0;25687087
2021-06-04;51872;9594;0;51864.0;25738959
2021-06-04;26;3;0;-51846.0;25738985
2021-06-04;2641;7063;0;2615.0;25741626
2021-06-04;10118;32300;0;7477.0;25751744
2021-06-04;22901;3862;0;12783.0;25774645
2021-06-04;7069;32223;0;-15832.0;25781714
2021-06-04;25;0;0;-7044.0;25781739
2021-06-04;38955;35762;1;38930.0;25820694
2021-06-05;19;3;0;-38936.0;25820713
2021-06-05;28633;3633;0;28614.0;25849346
2021-06-05;1829;12304;0;-26804.0;25851175
2021-06-05;25128;23932;0;23299.0;25876303
2021-06-05;4;0;0;-25124.0;25876307
2021-06-05;33884;6233;0;33880.0;25910191
2021-06-05;156584;104837;0;122700.0;26066775
2021-06-05;1280;163;0;-155304.0;26068055
2021-06-05;2935;18813;0;1655.0;26070990
2021-06-05;1132;3426;0;-1803.0;26072122
2021-06-05;779;2950;0;-353.0;26072901
2021-06-05;39336;9715;0;38557.0;26112237
2021-06-05;9;0;0;-39327.0;26112246
2021-06-05;16783;2659;0;16774.0;26129029
2021-06-05;4833;21006;0;-11950.0;26133862
2021-06-06;6;0;0;-4827.0;26133868
2021-06-06;7865;6157;0;7859.0;26141733
2021-06-06;1392;5201;0;-6473.0;26143125
2021-06-06;224;629;0;-1168.0;26143349
2021-06-06;470;2215;0;246.0;26143819
2021-06-06;764;4163;0;294.0;26144583
2021-06-06;716;70;0;-48.0;26145299
2021-06-06;2;0;0;-714.0;26145301
2021-06-06;17104;3630;0;17102.0;26162405
2021-06-06;241;711;0;-16863.0;26162646
2021-06-06;17214;2812;0;16973.0;26179860
2021-06-06;13509;1734;0;-3705.0;26193369
2021-06-06;10;1;0;-13499.0;26193379
2021-06-06;68360;28559;0;68350.0;26261739
2021-06-06;8843;1236;0;-59517.0;26270582
2021-06-07;6190;28561;0;-2653.0;26276772
2021-06-07;173235;136379;0;167045.0;26450007
2021-06-07;23610;26464;0;-149625.0;26473617
2021-06-07;40859;8873;0;17249.0;26514476
2021-06-07;28592;4260;0;-12267.0;26543068
2021-06-07;1505;5072;0;-27087.0;26544573
2021-06-07;4628;27151;0;3123.0;26549201
2021-06-07;16;0;0;-4612.0;26549217
2021-06-07;37;7;0;21.0;26549254
2021-06-07;20072;3675;0;20035.0;26569326
2021-06-07;42155;12741;0;22083.0;26611481
2021-06-07;31;3;0;-42124.0;26611512
2021-06-07;1344;121;0;1313.0;26612856
2021-06-07;1240;4385;0;-104.0;26614096
2021-06-07;2956;15066;0;1716.0;26617052
2021-06-08;6577;30784;0;3621.0;26623629
2021-06-08;1586;160;0;-4991.0;26625215
2021-06-08;2176;6205;0;590.0;26627391
2021-06-08;31757;4901;0;29581.0;26659148
2021-06-08;46158;9921;0;14401.0;26705306
2021-06-08;1663;5227;0;-44495.0;26706969
2021-06-08;16;0;0;-1647.0;26706985
2021-06-08;4162;18346;0;4146.0;26711147
2021-06-08;34;4;0;-4128.0;26711181
2021-06-08;28590;29908;0;28556.0;26739771
2021-06-08;22112;4076;0;-6478.0;26761883
2021-06-08;47647;14103;0;25535.0;26809530
2021-06-08;10;0;0;-47637.0;26809540
2021-06-08;200769;155388;0;200759.0;27010309
2021-06-08;8281;31753;0;-192488.0;27018590
2021-06-09;5813;25713;0;-2468.0;27024403
2021-06-09;18;5;0;-5795.0;27024421
2021-06-09;2462;235;0;2444.0;27026883
2021-06-09;2056;5477;0;-406.0;27028939
2021-06-09;45166;15400;0;43110.0;27074105
2021-06-09;3601;15467;0;-41565.0;27077706
2021-06-09;20932;4149;0;17331.0;27098638
2021-06-09;7337;27406;0;-13595.0;27105975
2021-06-09;43536;10417;0;36199.0;27149511
2021-06-09;189102;143344;0;145566.0;27338613
2021-06-09;1461;4495;0;-187641.0;27340074
2021-06-09;15;3;0;-1446.0;27340089
2021-06-09;25692;29590;0;25677.0;27365781
2021-06-09;17;0;0;-25675.0;27365798
2021-06-09;30996;4987;0;30979.0;27396794
2021-06-10;32575;5896;0;1579.0;27429369
2021-06-10;47439;16624;0;14864.0;27476808
2021-06-10;203778;154264;0;156339.0;27680586
2021-06-10;30;2;0;-203748.0;27680616
2021-06-10;4286;18164;0;4256.0;27684902
2021-06-10;10;3;0;-4276.0;27684912
2021-06-10;22498;4905;0;22488.0;27707410
2021-06-10;6774;27364;0;-15724.0;27714184
2021-06-10;1678;4963;0;-5096.0;27715862
2021-06-10;28973;31027;0;27295.0;27744835
2021-06-10;2401;6183;0;-26572.0;27747236
2021-06-10;28;3;0;-2373.0;27747264
2021-06-10;2121;201;0;2093.0;27749385
2021-06-10;46534;11744;0;44413.0;27795919
2021-06-10;8431;27185;0;-38103.0;27804350
2021-06-11;30315;42388;0;21884.0;27834665
2021-06-11;9;1;0;-30306.0;27834674
2021-06-11;18;7;0;9.0;27834692
2021-06-11;198387;192521;0;198369.0;28033079
2021-06-11;1586;5952;0;-196801.0;28034665
2021-06-11;7678;33789;0;6092.0;28042343
2021-06-11;12;1;0;-7666.0;28042355
2021-06-11;31103;5972;0;31091.0;28073458
2021-06-11;45263;13893;0;14160.0;28118721
2021-06-11;2324;248;0;-42939.0;28121045
2021-06-11;47522;22439;0;45198.0;28168567
2021-06-11;2154;7202;0;-45368.0;28170721
2021-06-11;3920;22606;0;1766.0;28174641
2021-06-11;5808;33080;0;1888.0;28180449
2021-06-11;20675;4943;0;14867.0;28201124
2021-06-12;1712;9715;0;-18963.0;28202836
2021-06-12;35112;18465;0;33400.0;28237948
2021-06-12;4149;17558;0;-30963.0;28242097
2021-06-12;9;4;0;-4140.0;28242106
2021-06-12;2650;15378;0;2641.0;28244756
2021-06-12;16778;4106;0;14128.0;28261534
2021-06-12;21647;28118;0;4869.0;28283181
2021-06-12;11;0;0;-21636.0;28283192
2021-06-12;2698;274;0;2687.0;28285890
2021-06-12;14;0;0;-2684.0;28285904
2021-06-12;691;2570;0;677.0;28286595
2021-06-12;147627;115540;0;146936.0;28434222
2021-06-12;32617;10925;0;-115010.0;28466839
2021-06-12;28578;5475;0;-4039.0;28495417
2021-06-12;961;2952;0;-27617.0;28496378
2021-06-13;1208;131;0;247.0;28497586
2021-06-13;10;1;0;-1198.0;28497596
2021-06-13;651;3626;0;641.0;28498247
2021-06-13;397;1906;0;-254.0;28498644
2021-06-13;12929;8979;0;12532.0;28511573
2021-06-13;1086;4641;0;-11843.0;28512659
2021-06-13;127;554;0;-959.0;28512786
2021-06-13;6215;9619;0;6088.0;28519001
2021-06-13;1;0;0;-6214.0;28519002
2021-06-13;7173;2091;0;7172.0;28526175
2021-06-13;13525;5687;0;6352.0;28539700
2021-06-13;10568;2553;0;-2957.0;28550268
2021-06-13;176;667;0;-10392.0;28550444
2021-06-13;54073;40456;0;53897.0;28604517
2021-06-13;7;1;0;-54066.0;28604524
2021-06-14;909;4702;0;902.0;28605433
2021-06-14;2375;16015;0;1466.0;28607808
2021-06-14;28597;16588;0;26222.0;28636405
2021-06-14;1135;5403;0;-27462.0;28637540
2021-06-14;16302;38835;0;15167.0;28653842
2021-06-14;122553;181072;0;106251.0;28776395
2021-06-14;4;2;0;-122549.0;28776399
2021-06-14;16;3;0;12.0;28776415
2021-06-14;3545;28141;0;3529.0;28779960
2021-06-14;27709;28462;0;24164.0;28807669
2021-06-14;14202;5593;0;-13507.0;28821871
2021-06-14;21165;6252;0;6963.0;28843036
2021-06-14;4510;30836;0;-16655.0;28847546
2021-06-14;18;3;0;-4492.0;28847564
2021-06-14;2066;237;0;2048.0;28849630
2021-06-15;156479;200466;0;154413.0;29006109
2021-06-15;1245;5657;0;-155234.0;29007354
2021-06-15;5982;31967;0;4737.0;29013336
2021-06-15;15;8;0;-5967.0;29013351
2021-06-15;3344;20616;0;3329.0;29016695
2021-06-15;1682;6758;0;-1662.0;29018377
2021-06-15;22829;6487;0;21147.0;29041206
2021-06-15;32039;18396;0;9210.0;29073245
2021-06-15;15927;6121;0;-16112.0;29089172
2021-06-15;32176;29954;0;16249.0;29121348
2021-06-15;19302;42082;0;-12874.0;29140650
2021-06-15;56;3;0;-19246.0;29140706
2021-06-15;17057;1039;0;17001.0;29157763
2021-06-15;4819;31378;0;-12238.0;29162582
2021-06-15;6;0;0;-4813.0;29162588
2021-06-16;9;2;0;3.0;29162597
2021-06-16;20658;6912;0;20649.0;29183255
2021-06-16;3877;24049;0;-16781.0;29187132
2021-06-16;1102;4493;0;-2775.0;29188234
2021-06-16;28790;18759;0;27688.0;29217024
2021-06-16;154870;181345;0;126080.0;29371894
2021-06-16;17;6;0;-154853.0;29371911
2021-06-16;30798;1889;0;30781.0;29402709
2021-06-16;13774;6334;0;-17024.0;29416483
2021-06-16;29075;31060;0;15301.0;29445558
2021-06-16;1458;5397;0;-27617.0;29447016
2021-06-16;2772;16043;0;1314.0;29449788
2021-06-16;17429;40793;0;14657.0;29467217
2021-06-16;117;10;0;-17312.0;29467334
2021-06-16;4994;25598;0;4877.0;29472328
2021-06-17;31753;20222;0;26759.0;29504081
2021-06-17;24;9;0;-31729.0;29504105
2021-06-17;50;8;0;26.0;29504155
2021-06-17;158724;198838;0;158674.0;29662879
2021-06-17;4755;27894;0;-153969.0;29667634
2021-06-17;6048;27454;0;1293.0;29673682
2021-06-17;1230;5132;0;-4818.0;29674912
2021-06-17;23044;8157;0;21814.0;29697956
2021-06-17;19318;1362;0;-3726.0;29717274
2021-06-17;1804;6371;0;-17514.0;29719078
2021-06-17;15429;7241;0;13625.0;29734507
2021-06-17;3279;20270;0;-12150.0;29737786
2021-06-17;19844;43403;0;16565.0;29757630
2021-06-17;32140;31311;0;12296.0;29789770
2021-06-17;6;4;0;-32134.0;29789776
2021-06-18;4130;29736;0;4124.0;29793906
2021-06-18;1680;6697;0;-2450.0;29795586
2021-06-18;17;2;0;-1663.0;29795603
2021-06-18;1199;5655;0;1182.0;29796802
2021-06-18;2748;21611;0;1549.0;29799550
2021-06-18;10;10;0;-2738.0;29799560
2021-06-18;55;8;0;45.0;29799615
2021-06-18;20665;58026;0;20610.0;29820280
2021-06-18;5634;30357;0;-15031.0;29825914
2021-06-18;163461;235776;0;157827.0;29989375
2021-06-18;28136;2115;0;-135325.0;30017511
2021-06-18;30455;24323;0;2319.0;30047966
2021-06-18;31636;39259;0;1181.0;30079602
2021-06-18;14171;8100;0;-17465.0;30093773
2021-06-18;22925;9877;0;8754.0;30116698
2021-06-19;9;3;0;-22916.0;30116707
2021-06-19;1739;11487;0;1730.0;30118446
2021-06-19;686;2400;0;-1053.0;30119132
2021-06-19;1159;7682;0;473.0;30120291
2021-06-19;67;7;0;-1092.0;30120358
2021-06-19;2868;14279;0;2801.0;30123226
2021-06-19;493;1959;0;-2375.0;30123719
2021-06-19;17875;9034;0;17382.0;30141594
2021-06-19;6;2;0;-17869.0;30141600
2021-06-19;115188;145148;0;115182.0;30256788
2021-06-19;19042;18229;0;-96146.0;30275830
2021-06-19;20917;30674;0;1875.0;30296747
2021-06-19;27113;2011;0;6196.0;30323860
2021-06-19;9787;6508;0;-17326.0;30333647
2021-06-19;13427;40873;0;3640.0;30347074
2021-06-20;9519;834;0;-3908.0;30356593
2021-06-20;19;3;0;-9500.0;30356612
2021-06-20;7233;9102;0;7214.0;30363845
2021-06-20;115;437;0;-7118.0;30363960
2021-06-20;609;3171;0;494.0;30364569
2021-06-20;3833;3450;0;3224.0;30368402
2021-06-20;5881;4323;0;2048.0;30374283
2021-06-20;238;1296;0;-5643.0;30374521
2021-06-20;3;0;0;-235.0;30374524
2021-06-20;6675;13566;0;6672.0;30381199
2021-06-20;3468;15821;0;-3207.0;30384667
2021-06-20;38048;54690;0;34580.0;30422715
2021-06-20;9;1;0;-38039.0;30422724
2021-06-20;98;402;0;89.0;30422822
2021-06-20;348;2284;0;250.0;30423170
2021-06-21;2476;19619;0;2128.0;30425646
2021-06-21;684;3593;0;-1792.0;30426330
2021-06-21;15644;10716;0;14960.0;30441974
2021-06-21;18657;25999;0;3013.0;30460631
2021-06-21;9603;9258;0;-9054.0;30470234
2021-06-21;3167;21747;0;-6436.0;30473401
2021-06-21;10948;58897;0;7781.0;30484349
2021-06-21;4;0;0;-10944.0;30484353
2021-06-21;98124;208216;1;98120.0;30582477
2021-06-21;16239;1352;0;-81885.0;30598716
2021-06-21;18082;40790;0;1843.0;30616798
2021-06-21;834;4310;0;-17248.0;30617632
2021-06-21;1734;11924;1;900.0;30619366
2021-06-21;37;3;0;-1697.0;30619403
2021-06-21;15;8;0;-22.0;30619418
2021-06-22;36;3;0;21.0;30619454
2021-06-22;17778;13484;0;17742.0;30637232
2021-06-22;25;9;0;-17753.0;30637257
2021-06-22;959;4727;0;934.0;30638216
2021-06-22;10742;11085;0;9783.0;30648958
2021-06-22;112227;243957;1;101485.0;30761185
2021-06-22;9;3;0;-112218.0;30761194
2021-06-22;1240;5327;0;1231.0;30762434
2021-06-22;4237;25747;0;2997.0;30766671
2021-06-22;3316;24449;0;-921.0;30769987
2021-06-22;13673;65940;1;10357.0;30783660
2021-06-22;16143;1475;0;2470.0;30799803
2021-06-22;2241;15936;0;-13902.0;30802044
2021-06-22;20892;45567;0;18651.0;30822936
2021-06-22;20936;30205;0;44.0;30843872
2021-06-23;18860;29840;0;-2076.0;30862732
2021-06-23;55;7;0;-18805.0;30862787
2021-06-23;12191;59938;0;12136.0;30874978
2021-06-23;3635;19654;0;-8556.0;30878613
2021-06-23;2050;11379;0;-1585.0;30880663
2021-06-23;18823;44944;1;16773.0;30899486
2021-06-23;9702;11130;0;-9121.0;30909188
2021-06-23;1184;4111;0;-8518.0;30910372
2021-06-23;16683;14421;0;15499.0;30927055
2021-06-23;5;0;0;-16678.0;30927060
2021-06-23;861;3371;0;856.0;30927921
2021-06-23;27004;2422;0;26143.0;30954925
2021-06-23;19;14;0;-26985.0;30954944
2021-06-23;2879;17745;0;2860.0;30957823
2021-06-23;113951;218976;1;111072.0;31071774
2021-06-24;61;10;0;-113890.0;31071835
2021-06-24;18;8;0;-43.0;31071853
2021-06-24;22073;42706;0;22055.0;31093926
2021-06-24;4762;20025;0;-17311.0;31098688
2021-06-24;2526;12820;0;-2236.0;31101214
2021-06-24;17768;1887;0;15242.0;31118982
2021-06-24;3682;19058;0;-14086.0;31122664
2021-06-24;8;2;0;-3674.0;31122672
2021-06-24;1123;3531;0;1115.0;31123795
2021-06-24;14837;54568;0;13714.0;31138632
2021-06-24;120724;219037;0;105887.0;31259356
2021-06-24;19102;16787;0;-101622.0;31278458
2021-06-24;11160;12172;0;-7942.0;31289618
2021-06-24;22200;30871;0;11040.0;31311818
2021-06-24;1404;4592;0;-20796.0;31313222
2021-06-25;15122;76447;0;13718.0;31328344
2021-06-25;115970;277554;0;100848.0;31444314
2021-06-25;2;0;0;-115968.0;31444316
2021-06-25;18;16;0;16.0;31444334
2021-06-25;9944;13922;0;9926.0;31454278
2021-06-25;17534;19722;0;7590.0;31471812
2021-06-25;2222;14899;0;-15312.0;31474034
2021-06-25;1034;4155;0;-1188.0;31475068
2021-06-25;3240;22950;0;2206.0;31478308
2021-06-25;1389;5380;0;-1851.0;31479697
2021-06-25;21483;55334;0;20094.0;31501180
2021-06-25;20930;37226;0;-553.0;31522110
2021-06-25;4482;25421;0;-16448.0;31526592
2021-06-25;18532;2077;0;14050.0;31545124
2021-06-25;38;5;0;-18494.0;31545162
2021-06-26;589;2156;0;551.0;31545751
2021-06-26;9960;57110;0;9371.0;31555711
2021-06-26;2294;12767;0;-7666.0;31558005
2021-06-26;16352;1997;0;14058.0;31574357
2021-06-26;16;4;0;-16336.0;31574373
2021-06-26;1441;9750;0;1425.0;31575814
2021-06-26;938;5786;0;-503.0;31576752
2021-06-26;31;9;0;-907.0;31576783
2021-06-26;451;1694;0;420.0;31577234
2021-06-26;12745;19323;0;12294.0;31589979
2021-06-26;6900;11864;0;-5845.0;31596879
2021-06-26;14451;44700;0;7551.0;31611330
2021-06-26;3;1;0;-14448.0;31611333
2021-06-26;79397;196597;0;79394.0;31690730
2021-06-26;13226;29436;0;-66171.0;31703956
2021-06-27;6086;813;0;-7140.0;31710042
2021-06-27;304;2097;0;-5782.0;31710346
2021-06-27;5241;15430;0;4937.0;31715587
2021-06-27;17;5;0;-5224.0;31715604
2021-06-27;2;1;0;-15.0;31715606
2021-06-27;559;3237;0;557.0;31716165
2021-06-27;5308;21401;0;4749.0;31721473
2021-06-27;2896;20666;0;-2412.0;31724369
2021-06-27;111;469;0;-2785.0;31724480
2021-06-27;2705;6324;0;2594.0;31727185
2021-06-27;4951;9712;0;2246.0;31732136
2021-06-27;10;5;0;-4941.0;31732146
2021-06-27;226;1170;0;216.0;31732372
2021-06-27;86;412;0;-140.0;31732458
2021-06-27;28502;81742;0;28416.0;31760960
2021-06-28;2121;15438;0;-26381.0;31763081
2021-06-28;7198;14349;0;5077.0;31770279
2021-06-28;10;13;0;-7188.0;31770289
2021-06-28;14022;36589;0;14012.0;31784311
2021-06-28;12950;1532;0;-1072.0;31797261
2021-06-28;2820;18561;0;-10130.0;31800081
2021-06-28;50;3;0;-2770.0;31800131
2021-06-28;733;3456;0;683.0;31800864
2021-06-28;77687;234353;0;76954.0;31878551
2021-06-28;13332;19763;0;-64355.0;31891883
2021-06-28;1370;8574;0;-11962.0;31893253
2021-06-28;604;2976;0;-766.0;31893857
2021-06-28;8864;61902;0;8260.0;31902721
2021-06-28;13609;51195;0;4745.0;31916330
2021-06-28;4;2;0;-13605.0;31916334
2021-06-29;19;10;0;15.0;31916353
2021-06-29;3;3;0;-16.0;31916356
2021-06-29;50;8;0;47.0;31916406
2021-06-29;15862;55419;0;15812.0;31932268
2021-06-29;3711;22423;0;-12151.0;31935979
2021-06-29;11251;67171;0;7540.0;31947230
2021-06-29;1144;4297;0;-10107.0;31948374
2021-06-29;2907;19727;0;1763.0;31951281
2021-06-29;92151;265580;0;89244.0;32043432
2021-06-29;15012;1983;0;-77139.0;32058444
2021-06-29;838;3562;0;-14174.0;32059282
2021-06-29;1920;11694;0;1082.0;32061202
2021-06-29;15932;40614;0;14012.0;32077134
2021-06-29;15129;22365;0;-803.0;32092263
2021-06-29;8373;16304;0;-6756.0;32100636
2021-06-30;18;8;0;-8355.0;32100654
2021-06-30;2806;15445;0;2788.0;32103460
2021-06-30;15579;38883;0;12773.0;32119039
2021-06-30;3719;18336;0;-11860.0;32122758
2021-06-30;57;42;0;-3662.0;32122815
2021-06-30;11251;59651;0;11194.0;32134066
2021-06-30;1072;3793;0;-10179.0;32135138
2021-06-30;13;9;0;-1059.0;32135151
2021-06-30;7704;15608;0;7691.0;32142855
2021-06-30;16170;54219;0;8466.0;32159025
2021-06-30;864;2938;0;-15306.0;32159889
2021-06-30;1879;8918;0;1015.0;32161768
2021-06-30;14349;22436;0;12470.0;32176117
2021-06-30;101172;243670;0;86823.0;32277289
2021-06-30;25691;3384;0;-75481.0;32302980
2021-07-01;4742;19674;0;-20949.0;32307722
2021-07-01;70;4;0;-4672.0;32307792
2021-07-01;3514;17601;0;3444.0;32311306
2021-07-01;117954;243880;0;114440.0;32429260
2021-07-01;19992;50853;0;-97962.0;32449252
2021-07-01;17989;23655;0;-2003.0;32467241
2021-07-01;11;6;0;-17978.0;32467252
2021-07-01;1091;3265;0;1080.0;32468343
2021-07-01;21065;39200;0;19974.0;32489408
2021-07-01;20778;2708;0;-287.0;32510186
2021-07-01;14110;56048;0;-6668.0;32524296
2021-07-01;24;18;0;-14086.0;32524320
2021-07-01;1439;4247;0;1415.0;32525759
2021-07-01;10682;15914;0;9243.0;32536441
2021-07-01;2447;10687;0;-8235.0;32538888
2021-07-02;117933;279629;2;115486.0;32656821
2021-07-02;19213;2780;0;-98720.0;32676034
2021-07-02;10379;17497;0;-8834.0;32686413
2021-07-02;1320;4701;0;-9059.0;32687733
2021-07-02;90;9;0;-1230.0;32687823
2021-07-02;4568;22460;0;4478.0;32692391
2021-07-02;14;13;0;-4554.0;32692405
2021-07-02;21309;59125;1;21295.0;32713714
2021-07-02;2285;12365;1;-19024.0;32715999
2021-07-02;17272;25801;0;14987.0;32733271
2021-07-02;10;2;0;-17262.0;32733281
2021-07-02;3285;19369;0;3275.0;32736566
2021-07-02;21481;43371;0;18196.0;32758047
2021-07-02;1049;3680;0;-20432.0;32759096
2021-07-02;15658;68456;0;14609.0;32774754
2021-07-03;2418;11120;0;-13240.0;32777172
2021-07-03;6;9;0;-2412.0;32777178
2021-07-03;29;8;0;23.0;32777207
2021-07-03;6281;14715;0;6252.0;32783488
2021-07-03;384;1399;1;-5897.0;32783872
2021-07-03;13728;46964;0;13344.0;32797600
2021-07-03;531;1888;0;-13197.0;32798131
2021-07-03;12479;34232;0;11948.0;32810610
2021-07-03;9795;48095;0;-2684.0;32820405
2021-07-03;933;4814;0;-8862.0;32821338
2021-07-03;1323;7824;0;390.0;32822661
2021-07-03;5;1;0;-1318.0;32822666
2021-07-03;14969;2406;0;14964.0;32837635
2021-07-03;74098;197467;1;59129.0;32911733
2021-07-03;11217;23992;0;-62881.0;32922950
2021-07-04;4726;10962;0;-6491.0;32927676
2021-07-04;103;348;0;-4623.0;32927779
2021-07-04;3;0;0;-100.0;32927782
2021-07-04;2752;7129;0;2749.0;32930534
2021-07-04;6;1;0;-2746.0;32930540
2021-07-04;29232;74638;0;29226.0;32959772
2021-07-04;363;1643;0;-28869.0;32960135
2021-07-04;3;3;0;-360.0;32960138
2021-07-04;5301;15716;0;5298.0;32965439
2021-07-04;5504;19304;0;203.0;32970943
2021-07-04;226;889;0;-5278.0;32971169
2021-07-04;6293;1088;0;6067.0;32977462
2021-07-04;3192;14461;0;-3101.0;32980654
2021-07-04;652;2674;0;-2540.0;32981306
2021-07-04;108;420;0;-544.0;32981414
2021-07-05;15249;40134;0;15141.0;32996663
2021-07-05;15354;2501;0;105.0;33012017
2021-07-05;7829;17210;0;-7525.0;33019846
2021-07-05;54;9;0;-7775.0;33019900
2021-07-05;3414;15018;0;3360.0;33023314
2021-07-05;15161;50910;0;11747.0;33038475
2021-07-05;10259;47907;0;-4902.0;33048734
2021-07-05;86117;222237;0;75858.0;33134851
2021-07-05;13345;24245;0;-72772.0;33148196
2021-07-05;2393;12189;0;-10952.0;33150589
2021-07-05;1607;6970;0;-786.0;33152196
2021-07-05;15;10;0;-1592.0;33152211
2021-07-05;5;2;0;-10.0;33152216
2021-07-05;764;2765;0;759.0;33152980
2021-07-05;668;2367;0;-96.0;33153648
2021-07-06;3222;16306;1;2554.0;33156870
2021-07-06;18086;54982;0;14864.0;33174956
2021-07-06;47;8;0;-18039.0;33175003
2021-07-06;15338;25954;0;15291.0;33190341
2021-07-06;2196;9583;0;-13142.0;33192537
2021-07-06;6;1;0;-2190.0;33192543
2021-07-06;917;3023;1;911.0;33193460
2021-07-06;18234;43740;0;17317.0;33211694
2021-07-06;1245;4003;0;-16989.0;33212939
2021-07-06;101398;254007;4;100153.0;33314337
2021-07-06;12;13;0;-101386.0;33314349
2021-07-06;8921;18397;0;8909.0;33323270
2021-07-06;12681;55499;0;3760.0;33335951
2021-07-06;16079;3397;0;3398.0;33352030
2021-07-06;4414;19101;2;-11665.0;33356444
2021-07-07;21181;5660;0;16767.0;33377625
2021-07-07;3112;11981;0;-18069.0;33380737
2021-07-07;18530;40785;0;15418.0;33399267
2021-07-07;8970;17438;0;-9560.0;33408237
2021-07-07;1181;3181;1;-7789.0;33409418
2021-07-07;15484;24799;0;14303.0;33424902
2021-07-07;4264;15046;0;-11220.0;33429166
2021-07-07;107416;226930;1;103152.0;33536582
2021-07-07;67;22;0;-107349.0;33536649
2021-07-07;22;13;0;-45.0;33536671
2021-07-07;10;0;0;-12.0;33536681
2021-07-07;878;2379;0;868.0;33537559
2021-07-07;2128;7026;0;1250.0;33539687
2021-07-07;18739;51568;0;16611.0;33558426
2021-07-07;12850;47032;0;-5889.0;33571276
2021-07-08;1454;3663;0;-11396.0;33572730
2021-07-08;117782;230907;2;116328.0;33690512
2021-07-08;20510;39963;0;-97272.0;33711022
2021-07-08;56;21;0;-20454.0;33711078
2021-07-08;19;17;0;-37.0;33711097
2021-07-08;21079;47867;1;21060.0;33732176
2021-07-08;19425;6687;0;-1654.0;33751601
2021-07-08;15202;46683;0;-4223.0;33766803
2021-07-08;5123;17247;0;-10079.0;33771926
2021-07-08;2599;8129;1;-2524.0;33774525
2021-07-08;7;3;0;-2592.0;33774532
2021-07-08;3743;14310;0;3736.0;33778275
2021-07-08;1142;2651;0;-2601.0;33779417
2021-07-08;17296;25862;0;16154.0;33796713
2021-07-08;10127;17804;0;-7169.0;33806840
2021-07-09;1403;3717;0;-8724.0;33808243
2021-07-09;2357;8507;0;954.0;33810600
2021-07-09;16698;31087;0;14341.0;33827298
2021-07-09;21379;49419;0;4681.0;33848677
2021-07-09;21646;60936;0;267.0;33870323
2021-07-09;5042;19307;0;-16604.0;33875365
2021-07-09;117372;281742;0;112330.0;33992737
2021-07-09;57;38;0;-117315.0;33992794
2021-07-09;10107;20723;0;10050.0;34002901
2021-07-09;3396;15349;0;-6711.0;34006297
2021-07-09;16668;60861;0;13272.0;34022965
2021-07-09;17577;8941;0;909.0;34040542
2021-07-09;18;5;0;-17559.0;34040560
2021-07-09;1011;2841;0;993.0;34041571
2021-07-09;13;11;0;-998.0;34041584
2021-07-10;433;1132;0;420.0;34042017
2021-07-10;3;2;0;-430.0;34042020
2021-07-10;12157;27432;0;12154.0;34054177
2021-07-10;2528;8950;0;-9629.0;34056705
2021-07-10;6995;16664;0;4467.0;34063700
2021-07-10;7;4;0;-6988.0;34063707
2021-07-10;996;3298;0;989.0;34064703
2021-07-10;15090;42930;0;14094.0;34079793
2021-07-10;1460;5935;0;-13630.0;34081253
2021-07-10;12861;7744;0;11401.0;34094114
2021-07-10;45;26;0;-12816.0;34094159
2021-07-10;11076;37862;0;11031.0;34105235
2021-07-10;607;1539;0;-10469.0;34105842
2021-07-10;14170;34957;0;13563.0;34120012
2021-07-10;78428;188475;0;64258.0;34198440
2021-07-11;258;609;0;-78170.0;34198698
2021-07-11;5666;3256;0;5408.0;34204364
2021-07-11;0;0;0;-5666.0;34204364
2021-07-11;5754;14285;0;5754.0;34210118
2021-07-11;102;222;0;-5652.0;34210220
2021-07-11;777;1728;0;675.0;34210997
2021-07-11;399;1015;0;-378.0;34211396
2021-07-11;6401;13611;0;6002.0;34217797
2021-07-11;5102;10175;0;-1299.0;34222899
2021-07-11;3232;6728;0;-1870.0;34226131
2021-07-11;4;4;0;-3228.0;34226135
2021-07-11;16;7;0;12.0;34226151
2021-07-11;126;306;0;110.0;34226277
2021-07-11;3587;8965;0;3461.0;34229864
2021-07-11;31424;60911;0;27837.0;34261288
2021-07-12;14920;59747;0;-16504.0;34276208
2021-07-12;10832;42881;0;-4088.0;34287040
2021-07-12;13270;35353;0;2438.0;34300310
2021-07-12;712;2026;0;-12558.0;34301022
2021-07-12;7908;24104;0;7196.0;34308930
2021-07-12;856;2427;0;-7052.0;34309786
2021-07-12;2382;9460;0;1526.0;34312168
2021-07-12;3295;12539;0;913.0;34315463
2021-07-12;15987;53037;0;12692.0;34331450
2021-07-12;13867;9652;0;-2120.0;34345317
2021-07-12;9;3;0;-13858.0;34345326
2021-07-12;43;19;0;34.0;34345369
2021-07-12;85687;256782;0;85644.0;34431056
2021-07-12;14;9;0;-85673.0;34431070
2021-07-12;1592;5525;0;1578.0;34432662
2021-07-13;1446;3307;0;-146.0;34434108
2021-07-13;71;30;0;-1375.0;34434179
2021-07-13;13618;27241;0;13547.0;34447797
2021-07-13;21;12;0;-13597.0;34447818
2021-07-13;2632;7061;0;2611.0;34450450
2021-07-13;22298;40109;0;19666.0;34472748
2021-07-13;21928;11491;0;-370.0;34494676
2021-07-13;17327;49032;0;-4601.0;34512003
2021-07-13;5759;15604;0;-11568.0;34517762
2021-07-13;141737;294338;0;135978.0;34659499
2021-07-13;24208;65517;0;-117529.0;34683707
2021-07-13;10;4;0;-24198.0;34683717
2021-07-13;1157;2611;0;1147.0;34684874
2021-07-13;3970;12188;0;2813.0;34688844
2021-07-13;27292;60131;0;23322.0;34716136
2021-07-14;604;950;0;-26688.0;34716740
2021-07-14;19408;21530;0;18804.0;34736148
2021-07-14;10213;10729;0;-9195.0;34746361
2021-07-14;90243;93575;0;80030.0;34836604
2021-07-14;327;527;0;-89916.0;34836931
2021-07-14;1107;1607;0;780.0;34838038
2021-07-14;16733;7379;0;15626.0;34854771
2021-07-14;1880;2422;0;-14853.0;34856651
2021-07-14;15;8;0;-1865.0;34856666
2021-07-14;5;2;0;-10.0;34856671
2021-07-14;55;22;0;50.0;34856726
2021-07-14;8607;10836;0;8552.0;34865333
2021-07-14;15554;16438;0;6947.0;34880887
2021-07-14;277;387;0;-15277.0;34881164
2021-07-14;15458;20738;0;15181.0;34896622
2021-07-15;3135;7073;0;-12323.0;34899757
2021-07-15;27540;41820;0;24405.0;34927297
2021-07-15;25503;15143;0;-2037.0;34952800
2021-07-15;17366;27192;0;-8137.0;34970166
2021-07-15;4568;11582;0;-12798.0;34974734
2021-07-15;28394;61083;0;23826.0;35003128
2021-07-15;6788;14816;0;-21606.0;35009916
2021-07-15;1322;2599;0;-5466.0;35011238
2021-07-15;171231;287975;0;169909.0;35182469
2021-07-15;91;45;0;-171140.0;35182560
2021-07-15;21;12;0;-70.0;35182581
2021-07-15;34021;58125;0;34000.0;35216602
2021-07-15;12;7;0;-34009.0;35216614
2021-07-15;1707;3424;0;1695.0;35218321
2021-07-15;20763;45054;0;19056.0;35239084
2021-07-16;19164;27314;0;-1599.0;35258248
2021-07-16;32206;61555;1;13042.0;35290454
2021-07-16;3276;7023;0;-28930.0;35293730
2021-07-16;5048;11704;0;1772.0;35298778
2021-07-16;90;44;0;-4958.0;35298868
2021-07-16;25465;15570;0;25375.0;35324333
2021-07-16;26;15;0;-25439.0;35324359
2021-07-16;1533;2638;0;1507.0;35325892
2021-07-16;24463;50235;0;22930.0;35350355
2021-07-16;38077;58044;0;13614.0;35388432
2021-07-16;7869;15731;0;-30208.0;35396301
2021-07-16;7;4;0;-7862.0;35396308
2021-07-16;30423;41559;0;30416.0;35426731
2021-07-16;1871;3486;0;-28552.0;35428602
2021-07-16;189518;294922;1;187647.0;35618120
2021-07-17;4124;7121;0;-185394.0;35622244
2021-07-17;16349;30759;0;12225.0;35638593
2021-07-17;665;1017;0;-15684.0;35639258
2021-07-17;133857;192322;0;133192.0;35773115
2021-07-17;23483;41267;0;-110374.0;35796598
2021-07-17;19388;11429;0;-4095.0;35815986
2021-07-17;864;1285;0;-18524.0;35816850
2021-07-17;2311;4443;0;1447.0;35819161
2021-07-17;26915;38261;0;24604.0;35846076
2021-07-17;1534;2590;0;-25381.0;35847610
2021-07-17;70;33;0;-1464.0;35847680
2021-07-17;23813;34172;0;23743.0;35871493
2021-07-17;20;18;0;-23793.0;35871513
2021-07-17;4;3;0;-16.0;35871517
2021-07-17;14317;19924;0;14313.0;35885834
2021-07-18;7065;8066;0;-7252.0;35892899
2021-07-18;12438;15524;0;5373.0;35905337
2021-07-18;365;525;0;-12073.0;35905702
2021-07-18;56154;68085;0;55789.0;35961856
2021-07-18;10631;12969;0;-45523.0;35972487
2021-07-18;161;269;0;-10470.0;35972648
2021-07-18;1091;1647;0;930.0;35973739
2021-07-18;2;0;0;-1089.0;35973741
2021-07-18;5442;8422;0;5440.0;35979183
2021-07-18;8;7;0;-5434.0;35979191
2021-07-18;29;13;0;21.0;35979220
2021-07-18;165;200;0;136.0;35979385
2021-07-18;9213;14610;0;9048.0;35988598
2021-07-18;578;934;0;-8635.0;35989176
2021-07-18;8966;4899;0;8388.0;35998142
2021-07-19;5173;10349;0;-3793.0;36003315
2021-07-19;1066;2178;0;-4107.0;36004381
2021-07-19;20;11;0;-1046.0;36004401
2021-07-19;28942;51327;0;28922.0;36033343
2021-07-19;2144;4606;0;-26798.0;36035487
2021-07-19;20938;14815;0;18794.0;36056425
2021-07-19;10;3;0;-20928.0;36056435
2021-07-19;22876;51198;0;22866.0;36079311
2021-07-19;3357;7843;0;-19519.0;36082668
2021-07-19;141754;240317;0;138397.0;36224422
2021-07-19;15251;24889;0;-126503.0;36239673
2021-07-19;16517;34903;0;1266.0;36256190
2021-07-19;69;38;0;-16448.0;36256259
2021-07-19;962;1763;0;893.0;36257221
2021-07-19;24429;36394;0;23467.0;36281650
2021-07-20;1682;3000;0;-22747.0;36283332
2021-07-20;188964;264894;0;187282.0;36472296
2021-07-20;4701;10284;0;-184263.0;36476997
2021-07-20;2991;6118;0;-1710.0;36479988
2021-07-20;31063;53339;0;28072.0;36511051
2021-07-20;20271;25961;0;-10792.0;36531322
2021-07-20;8;4;0;-20263.0;36531330
2021-07-20;25974;18301;0;25966.0;36557304
2021-07-20;7314;13268;0;-18660.0;36564618
2021-07-20;25;24;0;-7289.0;36564643
2021-07-20;38525;53521;0;38500.0;36603168
2021-07-20;32528;38881;0;-5997.0;36635696
2021-07-20;22386;39840;0;-10142.0;36658082
2021-07-20;111;55;0;-22275.0;36658193
2021-07-20;1385;2298;0;1274.0;36659578
2021-07-21;20913;22413;0;19528.0;36680491
2021-07-21;196010;237371;0;175097.0;36876501
2021-07-21;7;6;0;-196003.0;36876508
2021-07-21;22809;33271;0;22802.0;36899317
2021-07-21;1377;1943;0;-21432.0;36900694
2021-07-21;1598;2619;0;221.0;36902292
2021-07-21;32241;46019;0;30643.0;36934533
2021-07-21;2892;5104;0;-29349.0;36937425
2021-07-21;29936;26176;0;27044.0;36967361
2021-07-21;39886;46539;0;9950.0;37007247
2021-07-21;16;15;0;-39870.0;37007263
2021-07-21;110;67;0;94.0;37007373
2021-07-21;4358;8093;0;4248.0;37011731
2021-07-21;6796;10849;0;2438.0;37018527
2021-07-21;33071;34257;0;26275.0;37051598
2021-07-22;26010;35412;0;-7061.0;37077608
2021-07-22;3371;5852;1;-22639.0;37080979
2021-07-22;1491;2267;0;-1880.0;37082470
2021-07-22;88;48;0;-1403.0;37082558
2021-07-22;2024;3126;0;1936.0;37084582
2021-07-22;45522;44962;0;43498.0;37130104
2021-07-22;37683;34061;0;-7839.0;37167787
2021-07-22;219639;235783;1;181956.0;37387426
2021-07-22;7;3;0;-219632.0;37387433
2021-07-22;5219;9424;0;5212.0;37392652
2021-07-22;26;20;0;-5193.0;37392678
2021-07-22;24107;22519;0;24081.0;37416785
2021-07-22;7928;12184;0;-16179.0;37424713
2021-07-22;29776;22336;0;21848.0;37454489
2021-07-22;36387;43569;0;6611.0;37490876
2021-07-23;20;9;0;-36367.0;37490896
2021-07-23;5204;9233;0;5184.0;37496100
2021-07-23;37493;36844;0;32289.0;37533593
2021-07-23;46460;50494;0;8967.0;37580053
2021-07-23;1990;3090;0;-44470.0;37582043
2021-07-23;28431;25043;0;26441.0;37610474
2021-07-23;97;58;0;-28334.0;37610571
2021-07-23;38124;50196;0;38027.0;37648695
2021-07-23;28486;42173;1;-9638.0;37677181
2021-07-23;223913;261746;1;195427.0;37901094
2021-07-23;14;3;0;-223899.0;37901108
2021-07-23;24201;23565;0;24187.0;37925309
2021-07-23;8423;13066;0;-15778.0;37933732
2021-07-23;1589;2241;0;-6834.0;37935321
2021-07-23;3381;5731;0;1792.0;37938702
2021-07-24;17328;17102;0;13947.0;37956030
2021-07-24;2385;3126;0;-14943.0;37958415
2021-07-24;27052;29771;0;24667.0;37985467
2021-07-24;31457;32770;0;4405.0;38016924
2021-07-24;13;15;0;-31444.0;38016937
2021-07-24;1570;1981;0;1557.0;38018507
2021-07-24;8;2;0;-1562.0;38018515
2021-07-24;728;796;0;720.0;38019243
2021-07-24;864;1046;0;136.0;38020107
2021-07-24;4433;5280;0;3569.0;38024540
2021-07-24;75;37;0;-4358.0;38024615
2021-07-24;18448;24648;0;18373.0;38043063
2021-07-24;26125;33356;0;7677.0;38069188
2021-07-24;150616;169240;0;124491.0;38219804
2021-07-24;20130;19310;0;-130486.0;38239934
2021-07-25;656;669;0;-19474.0;38240590
2021-07-25;63676;51593;0;63020.0;38304266
2021-07-25;9737;7067;0;-53939.0;38314003
2021-07-25;11895;9294;0;2158.0;38325898
2021-07-25;377;408;0;-11518.0;38326275
2021-07-25;14213;10953;0;13836.0;38340488
2021-07-25;34;21;0;-14179.0;38340522
2021-07-25;175;142;0;141.0;38340697
2021-07-25;208;213;0;33.0;38340905
2021-07-25;6266;5911;0;6058.0;38347171
2021-07-25;2;2;0;-6264.0;38347173
2021-07-25;7843;5644;0;7841.0;38355016
2021-07-25;1333;1226;0;-6510.0;38356349
2021-07-25;6;5;0;-1327.0;38356355
2021-07-25;10931;10038;0;10925.0;38367286
2021-07-26;1302;1857;0;-9629.0;38368588
2021-07-26;3753;5762;0;2451.0;38372341
2021-07-26;17;6;0;-3736.0;38372358
2021-07-26;29112;36402;0;29095.0;38401470
2021-07-26;5855;7915;0;-23257.0;38407325
2021-07-26;176202;191971;0;170347.0;38583527
2021-07-26;30585;28456;0;-145617.0;38614112
2021-07-26;19552;17767;0;-11033.0;38633664
2021-07-26;20231;25412;0;679.0;38653895
2021-07-26;85;44;0;-20146.0;38653980
2021-07-26;2411;3627;0;2326.0;38656391
2021-07-26;26125;26583;0;23714.0;38682516
2021-07-26;1133;1522;0;-24992.0;38683649
2021-07-26;36017;36604;0;34884.0;38719666
2021-07-26;24;14;0;-35993.0;38719690
2021-07-27;20;24;0;-4.0;38719710
2021-07-27;40737;28761;0;40717.0;38760447
2021-07-27;8;1;0;-40729.0;38760455
2021-07-27;33076;24482;0;33068.0;38793531
2021-07-27;102;59;0;-32974.0;38793633
2021-07-27;5424;7602;0;5322.0;38799057
2021-07-27;38819;36904;0;33395.0;38837876
2021-07-27;3571;4678;0;-35248.0;38841447
2021-07-27;235733;201204;1;232162.0;39077180
2021-07-27;1609;1940;0;-234124.0;39078789
2021-07-27;1989;2514;0;380.0;39080778
2021-07-27;8536;10060;0;6547.0;39089314
2021-07-27;48172;36980;0;39636.0;39137486
2021-07-27;27488;28973;1;-20684.0;39164974
2021-07-27;26182;18226;0;-1306.0;39191156
2021-07-28;110;69;0;-26072.0;39191266
2021-07-28;3313;4069;0;3203.0;39194579
2021-07-28;38474;32003;0;35161.0;39233053
2021-07-28;35765;28263;0;-2709.0;39268818
2021-07-28;1521;1625;0;-34244.0;39270339
2021-07-28;47000;32501;0;45479.0;39317339
2021-07-28;25147;15409;0;-21853.0;39342486
2021-07-28;26700;24381;1;1553.0;39369186
2021-07-28;7866;8423;0;-18834.0;39377052
2021-07-28;1920;2235;0;-5946.0;39378972
2021-07-28;232432;181051;1;230512.0;39611404
2021-07-28;39514;25936;0;-192918.0;39650918
2021-07-28;18;18;0;-39496.0;39650936
2021-07-28;5076;6114;0;5058.0;39656012
2021-07-28;8;5;0;-5068.0;39656020
2021-07-29;41212;31246;0;41204.0;39697232
2021-07-29;8850;9467;0;-32362.0;39706082
2021-07-29;2317;2553;0;-6533.0;39708399
2021-07-29;3;3;0;-2314.0;39708402
2021-07-29;36956;22886;0;36953.0;39745358
2021-07-29;3900;4546;0;-33056.0;39749258
2021-07-29;248986;178727;0;245086.0;39998244
2021-07-29;130;54;0;-248856.0;39998374
2021-07-29;1822;1886;0;1692.0;40000196
2021-07-29;49639;31630;0;47817.0;40049835
2021-07-29;28;11;0;-49611.0;40049863
2021-07-29;29204;26297;0;29176.0;40079067
2021-07-29;26841;15583;0;-2363.0;40105908
2021-07-29;42263;25588;0;15422.0;40148171
2021-07-29;5821;6977;0;-36442.0;40153992
2021-07-30;2170;2554;0;-3651.0;40156162
2021-07-30;30341;30160;0;28171.0;40186503
2021-07-30;8408;9614;0;-21933.0;40194911
2021-07-30;1702;1827;0;-6706.0;40196613
2021-07-30;129;62;0;-1573.0;40196742
2021-07-30;5386;6946;0;5257.0;40202128
2021-07-30;14;11;0;-5372.0;40202142
2021-07-30;11;6;0;-3.0;40202153
2021-07-30;239544;194765;0;239533.0;40441697
2021-07-30;38804;27370;0;-200740.0;40480501
2021-07-30;35701;25283;0;-3103.0;40516202
2021-07-30;40356;35402;0;4655.0;40556558
2021-07-30;47885;34656;0;7529.0;40604443
2021-07-30;25190;16561;0;-22695.0;40629633
2021-07-30;3447;4313;0;-21743.0;40633080
2021-07-31;2416;2441;0;-1031.0;40635496
2021-07-31;4;2;0;-2412.0;40635500
2021-07-31;16;7;0;12.0;40635516
2021-07-31;26401;22592;0;26385.0;40661917
2021-07-31;87;52;0;-26314.0;40662004
2021-07-31;1570;1571;0;1483.0;40663574
2021-07-31;4379;4143;0;2809.0;40667953
2021-07-31;154192;121529;0;149813.0;40822145
2021-07-31;30813;22243;0;-123379.0;40852958
2021-07-31;26592;20277;0;-4221.0;40879550
2021-07-31;1017;885;0;-25575.0;40880567
2021-07-31;24530;18177;0;23513.0;40905097
2021-07-31;678;640;0;-23852.0;40905775
2021-07-31;16742;11312;0;16064.0;40922517
2021-07-31;18947;17187;0;2205.0;40941464
2021-08-01;7292;3644;0;-11655.0;40948756
2021-08-01;10788;5389;0;3496.0;40959544
2021-08-01;47;8;0;-10741.0;40959591
2021-08-01;4;0;0;-43.0;40959595
2021-08-01;60242;33629;0;60238.0;41019837
2021-08-01;9970;6156;0;-50272.0;41029807
2021-08-01;5906;3745;0;-4064.0;41035713
2021-08-01;4;0;0;-5902.0;41035717
2021-08-01;452;292;0;448.0;41036169
2021-08-01;1197;797;0;745.0;41037366
2021-08-01;12675;6936;0;11478.0;41050041
2021-08-01;236;158;0;-12439.0;41050277
2021-08-01;10864;5905;0;10628.0;41061141
2021-08-01;176;152;0;-10688.0;41061317
2021-08-01;631;447;0;455.0;41061948
2021-08-02;2517;2650;0;1886.0;41064465
2021-08-02;3726;3995;0;1209.0;41068191
2021-08-02;34259;25153;0;30533.0;41102450
2021-08-02;32451;25722;0;-1808.0;41134901
2021-08-02;29461;21381;0;-2990.0;41164362
2021-08-02;18390;12179;0;-11071.0;41182752
2021-08-02;1150;1111;0;-17240.0;41183902
2021-08-02;177786;142567;0;176636.0;41361688
2021-08-02;1299;1379;0;-176487.0;41362987
2021-08-02;19995;17928;0;18696.0;41382982
2021-08-02;5627;5584;0;-14368.0;41388609
2021-08-02;138;61;0;-5489.0;41388747
2021-08-02;15;1;0;-123.0;41388762
2021-08-02;15;14;0;0.0;41388777
2021-08-02;28743;25409;0;28728.0;41417520
2021-08-03;33474;22430;0;4731.0;41450994
2021-08-03;1923;1895;0;-31551.0;41452917
2021-08-03;24558;20644;0;22635.0;41477475
2021-08-03;38989;27239;0;14431.0;41516464
2021-08-03;7222;7136;0;-31767.0;41523686
2021-08-03;22;16;0;-7200.0;41523708
2021-08-03;1538;1446;0;1516.0;41525246
2021-08-03;33588;26561;0;32050.0;41558834
2021-08-03;4896;5246;0;-28692.0;41563730
2021-08-03;20452;13400;0;15556.0;41584182
2021-08-03;8;0;0;-20444.0;41584190
2021-08-03;207053;152183;1;207045.0;41791243
2021-08-03;155;54;0;-206898.0;41791398
2021-08-03;3334;3454;1;3179.0;41794732
2021-08-03;36894;22662;0;33560.0;41831626
2021-08-04;19196;11611;0;-17698.0;41850822
2021-08-04;1506;1224;1;-17690.0;41852328
2021-08-04;1843;1659;0;337.0;41854171
2021-08-04;31309;19494;0;29466.0;41885480
2021-08-04;3052;2675;0;-28257.0;41888532
2021-08-04;6843;5753;1;3791.0;41895375
2021-08-04;23286;16918;0;16443.0;41918661
2021-08-04;37006;23476;0;13720.0;41955667
2021-08-04;118;48;0;-36888.0;41955785
2021-08-04;199728;131495;2;199610.0;42155513
2021-08-04;38727;21972;0;-161001.0;42194240
2021-08-04;18;10;0;-38709.0;42194258
2021-08-04;4643;4159;0;4625.0;42198901
2021-08-04;11;2;0;-4632.0;42198912
2021-08-04;32170;22494;0;32159.0;42231082
2021-08-05;6952;6128;0;-25218.0;42238034
2021-08-05;30423;24041;0;23471.0;42268457
2021-08-05;30041;21310;0;-382.0;42298498
2021-08-05;2099;1932;0;-27942.0;42300597
2021-08-05;18507;13318;0;16408.0;42319104
2021-08-05;3212;3020;0;-15295.0;42322316
2021-08-05;189546;140126;0;186334.0;42511862
2021-08-05;121;59;0;-189425.0;42511983
2021-08-05;6;1;0;-115.0;42511989
2021-08-05;16;12;0;10.0;42512005
2021-08-05;34031;19610;0;34015.0;42546036
2021-08-05;4651;4373;0;-29380.0;42550687
2021-08-05;35249;26633;0;30598.0;42585936
2021-08-05;22636;18221;0;-12613.0;42608572
2021-08-05;1602;1468;0;-21034.0;42610174
2021-08-06;12;2;0;-1590.0;42610186
2021-08-06;3123;3251;0;3111.0;42613309
2021-08-06;133;66;0;-2990.0;42613442
2021-08-06;31738;21453;0;31605.0;42645180
2021-08-06;16;9;0;-31722.0;42645196
2021-08-06;23705;22673;0;23689.0;42668901
2021-08-06;1408;1405;0;-22297.0;42670309
2021-08-06;6821;6824;0;5413.0;42677130
2021-08-06;4542;4728;0;-2279.0;42681672
2021-08-06;31907;29417;0;27365.0;42713579
2021-08-06;28509;24890;0;-3398.0;42742088
2021-08-06;188308;164589;0;159799.0;42930396
2021-08-06;2033;1919;0;-186275.0;42932429
2021-08-06;18279;15720;0;16246.0;42950708
2021-08-06;36082;32232;0;17803.0;42986790
2021-08-07;3291;3376;0;-32791.0;42990081
2021-08-07;8;6;0;-3283.0;42990089
2021-08-07;14372;14071;0;14364.0;43004461
2021-08-07;20119;20283;1;5747.0;43024580
2021-08-07;3;0;0;-20116.0;43024583
2021-08-07;116385;110170;1;116382.0;43140968
2021-08-07;846;771;0;-115539.0;43141814
2021-08-07;1336;1339;0;490.0;43143150
2021-08-07;88;49;0;-1248.0;43143238
2021-08-07;653;581;0;565.0;43143891
2021-08-07;20095;15195;0;19442.0;43163986
2021-08-07;23245;22338;0;3150.0;43187231
2021-08-07;11883;11400;0;-11362.0;43199114
2021-08-07;18416;18738;0;6533.0;43217530
2021-08-07;2030;2023;0;-16386.0;43219560
2021-08-08;325;307;0;-1705.0;43219885
2021-08-08;142;139;0;-183.0;43220027
2021-08-08;546;514;0;404.0;43220573
2021-08-08;40326;37780;0;39780.0;43260899
2021-08-08;4032;3845;0;-36294.0;43264931
2021-08-08;6697;6662;0;2665.0;43271628
2021-08-08;866;812;0;-5831.0;43272494
2021-08-08;211;195;0;-655.0;43272705
2021-08-08;4595;4656;0;4384.0;43277300
2021-08-08;8423;8513;0;3828.0;43285723
2021-08-08;6;3;0;-8417.0;43285729
2021-08-08;7629;5149;0;7623.0;43293358
2021-08-08;27;15;0;-7602.0;43293385
2021-08-08;2;1;0;-25.0;43293387
2021-08-08;6825;6969;0;6823.0;43300212
2021-08-09;15550;17147;0;8725.0;43315762
2021-08-09;136209;148890;0;120659.0;43451971
2021-08-09;2036;2357;0;-134173.0;43454007
2021-08-09;22152;25348;0;20116.0;43476159
2021-08-09;1257;1383;0;-20895.0;43477416
2021-08-09;21154;24386;0;19897.0;43498570
2021-08-09;11;16;0;-21143.0;43498581
2021-08-09;26180;29533;0;26169.0;43524761
2021-08-09;945;1079;0;-25235.0;43525706
2021-08-09;3009;3518;0;2064.0;43528715
2021-08-09;25459;23794;0;22450.0;43554174
2021-08-09;4615;5191;0;-20844.0;43558789
2021-08-09;102;79;0;-4513.0;43558891
2021-08-09;6;4;0;-96.0;43558897
2021-08-09;13733;15055;0;13727.0;43572630
2021-08-10;19652;19732;0;5919.0;43592282
2021-08-10;128;64;0;-19524.0;43592410
2021-08-10;28039;22312;0;27911.0;43620449
2021-08-10;30839;32158;0;2800.0;43651288
2021-08-10;25;10;0;-30814.0;43651313
2021-08-10;8;1;0;-17.0;43651321
2021-08-10;162608;162400;0;162600.0;43813929
2021-08-10;3982;4564;0;-158626.0;43817911
2021-08-10;1773;1783;0;-2209.0;43819684
2021-08-10;24921;26614;0;23148.0;43844605
2021-08-10;2881;3167;0;-22040.0;43847486
2021-08-10;6028;6551;0;3147.0;43853514
2021-08-10;1450;1547;0;-4578.0;43854964
2021-08-10;16504;16696;0;15054.0;43871468
2021-08-10;26378;27201;0;9874.0;43897846
2021-08-11;1700;1660;0;-24678.0;43899546
2021-08-11;147729;150002;0;146029.0;44047275
2021-08-11;2540;2636;0;-145189.0;44049815
2021-08-11;22130;24643;0;19590.0;44071945
2021-08-11;23778;24857;0;1648.0;44095723
2021-08-11;110;57;0;-23668.0;44095833
2021-08-11;5343;5535;0;5233.0;44101176
2021-08-11;1251;1251;0;-4092.0;44102427
2021-08-11;26860;22195;0;25609.0;44129287
2021-08-11;27972;30064;0;1112.0;44157259
2021-08-11;14715;15717;0;-13257.0;44171974
2021-08-11;7;3;0;-14708.0;44171981
2021-08-11;17;12;0;10.0;44171998
2021-08-11;3604;3925;0;3587.0;44175602
2021-08-11;17702;17447;0;14098.0;44193304
2021-08-12;21395;26605;0;3693.0;44214699
2021-08-12;14185;17258;0;-7210.0;44228884
2021-08-12;91;63;0;-14094.0;44228975
2021-08-12;23508;21013;0;23417.0;44252483
2021-08-12;23305;26552;0;-203.0;44275788
2021-08-12;27226;32661;0;3921.0;44303014
2021-08-12;2759;3017;0;-24467.0;44305773
2021-08-12;142993;160274;0;140234.0;44448766
2021-08-12;5;4;0;-142988.0;44448771
2021-08-12;1876;1892;0;1871.0;44450647
2021-08-12;3824;4397;0;1948.0;44454471
2021-08-12;17757;19084;0;13933.0;44472228
2021-08-12;5728;6340;0;-12029.0;44477956
2021-08-12;15;16;0;-5713.0;44477971
2021-08-12;1319;1372;0;1304.0;44479290
2021-08-13;2;2;0;-1317.0;44479292
2021-08-13;20391;27356;0;20389.0;44499683
2021-08-13;1134;1237;0;-19257.0;44500817
2021-08-13;22;5;0;-1112.0;44500839
2021-08-13;101;60;0;79.0;44500940
2021-08-13;26097;33294;1;25996.0;44527037
2021-08-13;22669;27561;0;-3428.0;44549706
2021-08-13;4937;5866;0;-17732.0;44554643
2021-08-13;21642;20664;0;16705.0;44576285
2021-08-13;3341;4066;0;-18301.0;44579626
2021-08-13;1675;1652;0;-1666.0;44581301
2021-08-13;16765;19759;0;15090.0;44598066
2021-08-13;135033;161726;2;118268.0;44733099
2021-08-13;2370;2658;1;-132663.0;44735469
2021-08-13;13887;17546;0;11517.0;44749356
2021-08-14;72;49;0;-13815.0;44749428
2021-08-14;667;726;0;595.0;44750095
2021-08-14;985;1190;0;318.0;44751080
2021-08-14;2349;3122;0;1364.0;44753429
2021-08-14;13674;20419;0;11325.0;44767103
2021-08-14;1;0;0;-13673.0;44767104
2021-08-14;12498;21054;0;12497.0;44779602
2021-08-14;1328;1803;0;-11170.0;44780930
2021-08-14;16146;24782;0;14818.0;44797076
2021-08-14;14250;14830;0;-1896.0;44811326
2021-08-14;18;11;0;-14232.0;44811344
2021-08-14;9760;13841;0;9742.0;44821104
2021-08-14;80896;115912;0;71136.0;44902000
2021-08-14;8708;13534;0;-72188.0;44910708
2021-08-14;440;551;0;-8268.0;44911148
2021-08-15;2693;3764;0;2253.0;44913841
2021-08-15;543;622;0;-2150.0;44914384
2021-08-15;2098;2922;0;1555.0;44916482
2021-08-15;278;342;0;-1820.0;44916760
2021-08-15;3473;4878;0;3195.0;44920233
2021-08-15;4648;6502;0;1175.0;44924881
2021-08-15;1;0;0;-4647.0;44924882
2021-08-15;189;193;0;188.0;44925071
2021-08-15;1;2;0;-188.0;44925072
2021-08-15;3943;3935;0;3942.0;44929015
2021-08-15;21775;29069;0;17832.0;44950790
2021-08-15;97;103;0;-21678.0;44950887
2021-08-15;3680;5672;0;3583.0;44954567
2021-08-15;14;16;0;-3666.0;44954581
2021-08-15;117;118;0;103.0;44954698
2021-08-16;1444;2197;0;1327.0;44956142
2021-08-16;12;14;0;-1432.0;44956154
2021-08-16;19574;28428;0;19562.0;44975728
2021-08-16;18650;35705;0;-924.0;44994378
2021-08-16;775;1036;0;-17875.0;44995153
2021-08-16;2173;3393;0;1398.0;44997326
2021-08-16;14591;29997;0;12418.0;45011917
2021-08-16;9840;19292;0;-4751.0;45021757
2021-08-16;1059;1289;0;-8781.0;45022816
2021-08-16;6;2;0;-1053.0;45022822
2021-08-16;85;81;0;79.0;45022907
2021-08-16;15532;29310;0;15447.0;45038439
2021-08-16;11098;19099;0;-4434.0;45049537
2021-08-16;98174;175056;0;87076.0;45147711
2021-08-16;3335;5213;0;-94839.0;45151046
2021-08-17;96;76;0;-3239.0;45151142
2021-08-17;2023;2959;0;1927.0;45153165
2021-08-17;14;11;0;-2009.0;45153179
2021-08-17;13339;21547;0;13325.0;45166518
2021-08-17;21567;26569;0;8228.0;45188085
2021-08-17;21264;37954;0;-303.0;45209349
2021-08-17;1084;1444;0;-20180.0;45210433
2021-08-17;113717;187196;0;112633.0;45324150
2021-08-17;2773;4295;0;-110944.0;45326923
2021-08-17;16605;32230;0;13832.0;45343528
2021-08-17;4172;6460;0;-12433.0;45347700
2021-08-17;18092;30996;0;13920.0;45365792
2021-08-17;2;2;0;-18090.0;45365794
2021-08-17;1474;1860;0;1472.0;45367268
2021-08-17;11212;20793;0;9738.0;45378480
2021-08-18;3735;6156;1;-7477.0;45382215
2021-08-18;912;1254;1;-2823.0;45383127
2021-08-18;27;11;0;-885.0;45383154
2021-08-18;2469;3944;0;2442.0;45385623
2021-08-18;1347;1599;0;-1122.0;45386970
2021-08-18;12039;20098;0;10692.0;45399009
2021-08-18;103672;179517;3;91633.0;45502681
2021-08-18;18877;36411;0;-84795.0;45521558
2021-08-18;16025;29726;0;-2852.0;45537583
2021-08-18;21740;27657;0;5715.0;45559323
2021-08-18;85;83;0;-21655.0;45559408
2021-08-18;9801;19525;0;9716.0;45569209
2021-08-18;8;3;0;-9793.0;45569217
2021-08-18;1756;2694;1;1748.0;45570973
2021-08-18;14851;30356;0;13095.0;45585824
2021-08-19;1532;1821;0;-13319.0;45587356
2021-08-19;15496;30334;0;13964.0;45602852
2021-08-19;9903;19988;0;-5593.0;45612755
2021-08-19;18616;36573;0;8713.0;45631371
2021-08-19;100511;181198;0;81895.0;45731882
2021-08-19;2628;4324;0;-97883.0;45734510
2021-08-19;3902;6479;0;1274.0;45738412
2021-08-19;97;67;0;-3805.0;45738509
2021-08-19;14311;30888;0;14214.0;45752820
2021-08-19;15;11;0;-14296.0;45752835
2021-08-19;984;1434;0;969.0;45753819
2021-08-19;19149;25132;0;18165.0;45772968
2021-08-19;2;3;0;-19147.0;45772970
2021-08-19;1804;2948;0;1802.0;45774774
2021-08-19;12072;21196;0;10268.0;45786846
2021-08-20;19078;29458;0;7006.0;45805924
2021-08-20;9629;22047;0;-9449.0;45815553
2021-08-20;1;3;0;-9628.0;45815554
2021-08-20;18228;41885;0;18227.0;45833782
2021-08-20;11989;25268;0;-6239.0;45845771
2021-08-20;80;104;0;-11909.0;45845851
2021-08-20;98092;205488;0;98012.0;45943943
2021-08-20;19;16;0;-98073.0;45943962
2021-08-20;15558;35434;0;15539.0;45959520
2021-08-20;2340;4464;0;-13218.0;45961860
2021-08-20;1657;2820;0;-683.0;45963517
2021-08-20;976;1412;0;-681.0;45964493
2021-08-20;13617;33766;0;12641.0;45978110
2021-08-20;1346;1902;0;-12271.0;45979456
2021-08-20;3574;6909;0;2228.0;45983030
2021-08-21;618;1220;0;-2956.0;45983648
2021-08-21;56550;137230;0;55932.0;46040198
2021-08-21;59;74;0;-56491.0;46040257
2021-08-21;9019;24165;0;8960.0;46049276
2021-08-21;12350;21349;0;3331.0;46061626
2021-08-21;5668;15477;0;-6682.0;46067294
2021-08-21;10645;28038;0;4977.0;46077939
2021-08-21;575;770;0;-10070.0;46078514
2021-08-21;933;1880;0;358.0;46079447
2021-08-21;8397;23879;0;7464.0;46087844
2021-08-21;352;578;0;-8045.0;46088196
2021-08-21;8;7;0;-344.0;46088204
2021-08-21;4;0;0;-4.0;46088208
2021-08-21;1603;3444;0;1599.0;46089811
2021-08-21;6319;16349;0;4716.0;46096130
2021-08-22;359;940;0;-5960.0;46096489
2021-08-22;19;27;0;-340.0;46096508
2021-08-22;78;159;0;59.0;46096586
2021-08-22;2459;8317;1;2381.0;46099045
2021-08-22;0;1;0;-2459.0;46099045
2021-08-22;1;2;0;1.0;46099046
2021-08-22;17019;49746;1;17018.0;46116065
2021-08-22;64;126;0;-16955.0;46116129
2021-08-22;1504;4915;0;1440.0;46117633
2021-08-22;121;331;0;-1383.0;46117754
2021-08-22;190;498;0;69.0;46117944
2021-08-22;4413;8506;0;4223.0;46122357
2021-08-22;3337;10759;0;-1076.0;46125694
2021-08-22;2686;9158;0;-651.0;46128380
2021-08-22;1788;6007;0;-898.0;46130168
2021-08-23;7579;20432;0;5791.0;46137747
2021-08-23;584;1110;0;-6995.0;46138331
2021-08-23;786;1360;0;202.0;46139117
2021-08-23;1531;3525;0;745.0;46140648
2021-08-23;18283;37907;0;16752.0;46158931
2021-08-23;12829;37995;0;-5454.0;46171760
2021-08-23;4;2;0;-12825.0;46171764
2021-08-23;2349;5346;0;2345.0;46174113
2021-08-23;10576;32341;0;8227.0;46184689
2021-08-23;10658;31791;0;82.0;46195347
2021-08-23;1101;2319;0;-9557.0;46196448
2021-08-23;6758;20046;0;5657.0;46203206
2021-08-23;65;114;0;-6693.0;46203271
2021-08-23;11;14;0;-54.0;46203282
2021-08-23;73114;194302;0;73103.0;46276396
2021-08-24;1494;3011;0;-71620.0;46277890
2021-08-24;19447;36018;0;17953.0;46297337
2021-08-24;2110;4511;0;-17337.0;46299447
2021-08-24;74;119;0;-2036.0;46299521
2021-08-24;11;12;0;-63.0;46299532
2021-08-24;12547;34385;0;12536.0;46312079
2021-08-24;11986;34478;0;-561.0;46324065
2021-08-24;7946;21192;0;-4040.0;46332011
2021-08-24;4;3;0;-7942.0;46332015
2021-08-24;9294;23565;0;9290.0;46341309
2021-08-24;791;1382;0;-8503.0;46342100
2021-08-24;84683;207668;0;83892.0;46426783
2021-08-24;3048;6691;0;-81635.0;46429831
2021-08-24;1209;1895;0;-1839.0;46431040
2021-08-24;14722;40406;0;13513.0;46445762
2021-08-25;6778;18567;0;-7944.0;46452540
2021-08-25;10646;30518;0;3868.0;46463186
2021-08-25;3;4;0;-10643.0;46463189
2021-08-25;1342;2721;0;1339.0;46464531
2021-08-25;20314;38780;0;18972.0;46484845
2021-08-25;1023;1710;0;-19291.0;46485868
2021-08-25;77266;191421;1;76243.0;46563134
2021-08-25;7964;21307;0;-69302.0;46571098
2021-08-25;658;1336;0;-7306.0;46571756
2021-08-25;1719;3947;0;1061.0;46573475
2021-08-25;77;116;0;-1642.0;46573552
2021-08-25;13077;35788;1;13000.0;46586629
2021-08-25;11010;30730;0;-2067.0;46597639
2021-08-25;10;8;0;-11000.0;46597649
2021-08-25;2645;5889;0;2635.0;46600294
2021-08-26;8288;21832;0;5643.0;46608582
2021-08-26;71;100;0;-8217.0;46608653
2021-08-26;1404;3007;0;1333.0;46610057
2021-08-26;6570;18639;0;5166.0;46616627
2021-08-26;11;14;0;-6559.0;46616638
2021-08-26;2654;6196;0;2643.0;46619292
2021-08-26;11067;30598;0;8413.0;46630359
2021-08-26;8;2;0;-11059.0;46630367
2021-08-26;73167;188259;0;73159.0;46703534
2021-08-26;12661;35597;0;-60506.0;46716195
2021-08-26;9762;30137;0;-2899.0;46725957
2021-08-26;1796;4221;0;-7966.0;46727753
2021-08-26;1156;1941;0;-640.0;46728909
2021-08-26;16960;34541;0;15804.0;46745869
2021-08-26;759;1434;0;-16201.0;46746628
2021-08-27;2;4;0;-757.0;46746630
2021-08-27;76399;216380;1;76397.0;46823029
2021-08-27;13406;41518;0;-62993.0;46836435
2021-08-27;6886;20804;0;-6520.0;46843321
2021-08-27;10027;32516;0;3141.0;46853348
2021-08-27;110;124;0;-9917.0;46853458
2021-08-27;8896;25938;1;8786.0;46862354
2021-08-27;17949;40222;0;9053.0;46880303
2021-08-27;7;8;0;-17942.0;46880310
2021-08-27;1249;3055;0;1242.0;46881559
2021-08-27;1768;4446;0;519.0;46883327
2021-08-27;723;1462;0;-1045.0;46884050
2021-08-27;11655;37432;0;10932.0;46895705
2021-08-27;1122;2063;0;-10533.0;46896827
2021-08-27;2599;6788;0;1477.0;46899426
2021-08-28;7143;24602;0;4544.0;46906569
2021-08-28;48040;142938;0;40897.0;46954609
2021-08-28;1;3;0;-48039.0;46954610
2021-08-28;8255;27492;0;8254.0;46962865
2021-08-28;78;91;0;-8177.0;46962943
2021-08-28;782;1934;0;704.0;46963725
2021-08-28;308;649;0;-474.0;46964033
2021-08-28;463;836;0;155.0;46964496
2021-08-28;5172;16667;0;4709.0;46969668
2021-08-28;4185;14116;0;-987.0;46973853
2021-08-28;1339;3393;0;-2846.0;46975192
2021-08-28;6648;22727;0;5309.0;46981840
2021-08-28;4;8;0;-6644.0;46981844
2021-08-28;548;1205;0;544.0;46982392
2021-08-28;13114;29215;0;12566.0;46995506
2021-08-29;2013;7518;0;-11101.0;46997519
2021-08-29;14369;47056;0;12356.0;47011888
2021-08-29;1095;4293;0;-13274.0;47012983
2021-08-29;0;0;0;-1095.0;47012983
2021-08-29;21;44;0;21.0;47013004
2021-08-29;2;0;0;-19.0;47013006
2021-08-29;2562;9222;0;2560.0;47015568
2021-08-29;4572;11421;0;2010.0;47020140
2021-08-29;155;481;0;-4417.0;47020295
2021-08-29;96;281;0;-59.0;47020391
2021-08-29;65;208;0;-31.0;47020456
2021-08-29;2103;7510;0;2038.0;47022559
2021-08-29;270;872;0;-1833.0;47022829
2021-08-29;1352;5038;0;1082.0;47024181
2021-08-29;63;168;0;-1289.0;47024244
2021-08-30;656;1196;793;593.0;47024900
2021-08-30;5024;15904;54;4368.0;47029924
2021-08-30;1745;4718;187;-3279.0;47031669
2021-08-30;97;141;0;-1648.0;47031766
2021-08-30;5554;17727;262;5457.0;47037320
2021-08-30;9375;31267;96;3821.0;47046695
2021-08-30;459;946;692;-8916.0;47047154
2021-08-30;7922;27347;125;7463.0;47055076
2021-08-30;790;2057;430;-7132.0;47055866
2021-08-30;8215;26261;47;7425.0;47064081
2021-08-30;19114;46293;10;10899.0;47083195
2021-08-30;60082;176904;3004;40968.0;47143277
2021-08-30;1126;3037;307;-58956.0;47144403
2021-08-30;3;7;1;-1123.0;47144406
2021-08-30;2;3;0;-1.0;47144408
2021-08-31;2126;5874;333;2124.0;47146534
2021-08-31;1500;3858;633;-626.0;47148034
2021-08-31;579;1313;1869;-921.0;47148613
2021-08-31;19176;40851;7;18597.0;47167789
2021-08-31;8919;27646;57;-10257.0;47176708
2021-08-31;10881;33646;94;1962.0;47187589
2021-08-31;1093;2701;741;-9788.0;47188682
2021-08-31;115;165;0;-978.0;47188797
2021-08-31;6817;20495;393;6702.0;47195614
2021-08-31;13;14;1;-6804.0;47195627
2021-08-31;66990;185162;6173;66977.0;47262617
2021-08-31;5603;16987;46;-61387.0;47268220
2021-08-31;881;1729;1845;-4722.0;47269101
2021-08-31;6;4;1;-875.0;47269107
2021-08-31;9281;29879;153;9275.0;47278388
2021-09-01;71091;158647;12781;61810.0;47349479
2021-09-01;12739;29306;156;-58352.0;47362218
2021-09-01;19;5;0;-12720.0;47362237
2021-09-01;1316;3381;1097;1297.0;47363553
2021-09-01;19108;34513;14;17792.0;47382661
2021-09-01;604;1153;4177;-18504.0;47383265
2021-09-01;6778;17711;551;6174.0;47390043
2021-09-01;6809;14870;69;31.0;47396852
2021-09-01;9611;23520;67;2802.0;47406463
2021-09-01;177;133;0;-9434.0;47406640
2021-09-01;2029;4918;462;1852.0;47408669
2021-09-01;796;1485;4502;-1233.0;47409465
2021-09-01;26;10;1;-770.0;47409491
2021-09-01;1062;2291;1486;1036.0;47410553
2021-09-01;10017;25351;199;8955.0;47420570
2021-09-02;59469;138675;15017;49452.0;47480039
2021-09-02;13;4;0;-59456.0;47480052
2021-09-02;11887;28994;160;11874.0;47491939
2021-09-02;14;2;1;-11873.0;47491953
2021-09-02;1478;3749;1279;1464.0;47493431
2021-09-02;10180;16228;6;8702.0;47503611
2021-09-02;9366;24581;197;-814.0;47512977
2021-09-02;610;1281;4941;-8756.0;47513587
2021-09-02;1070;2591;1656;460.0;47514657
2021-09-02;6061;14654;53;4991.0;47520718
2021-09-02;9038;21787;67;2977.0;47529756
2021-09-02;6581;17643;665;-2457.0;47536337
2021-09-02;102;71;0;-6479.0;47536439
2021-09-02;2106;5302;600;2004.0;47538545
2021-09-02;963;1788;5392;-1143.0;47539508
2021-09-03;11983;35235;172;11020.0;47551491
2021-09-03;5949;17357;65;-6034.0;47557440
2021-09-03;626;1334;5418;-5323.0;47558066
2021-09-03;7056;21917;806;6430.0;47565122
2021-09-03;997;1923;6054;-6059.0;47566119
2021-09-03;9942;30964;255;8945.0;47576061
2021-09-03;8872;24557;60;-1070.0;47584933
2021-09-03;2220;5776;701;-6652.0;47587153
2021-09-03;60702;164632;16670;58482.0;47647855
2021-09-03;1506;3719;1363;-59196.0;47649361
2021-09-03;9;4;0;-1497.0;47649370
2021-09-03;1132;2703;1770;1123.0;47650502
2021-09-03;10318;19032;5;9186.0;47660820
2021-09-03;77;97;0;-10241.0;47660897
2021-09-03;15;14;1;-62.0;47660912
2021-09-04;7;9;1;-8.0;47660919
2021-09-04;707;1433;608;700.0;47661626
2021-09-04;4278;13331;434;3571.0;47665904
2021-09-04;109;127;0;-4169.0;47666013
2021-09-04;1113;2731;358;1004.0;47667126
2021-09-04;3847;11297;47;2734.0;47670973
2021-09-04;6;5;0;-3841.0;47670979
2021-09-04;6239;20239;136;6233.0;47677218
2021-09-04;7390;22385;120;1151.0;47684608
2021-09-04;443;725;2369;-6947.0;47685051
2021-09-04;6084;18777;41;5641.0;47691135
2021-09-04;46564;124904;7009;40480.0;47737699
2021-09-04;466;1022;769;-46098.0;47738165
2021-09-04;15601;32285;6;15135.0;47753766
2021-09-04;274;538;2120;-15327.0;47754040
2021-09-05;25;22;0;-249.0;47754065
2021-09-05;7;1;0;-18.0;47754072
2021-09-05;120;265;197;113.0;47754192
2021-09-05;1878;5338;44;1758.0;47756070
2021-09-05;3486;5850;3;1608.0;47759556
2021-09-05;11045;26633;2353;7559.0;47770601
2021-09-05;226;547;103;-10819.0;47770827
2021-09-05;0;2;0;-226.0;47770827
2021-09-05;76;137;811;76.0;47770903
2021-09-05;908;2813;17;832.0;47771811
2021-09-05;52;85;739;-856.0;47771863
2021-09-05;95;180;265;43.0;47771958
2021-09-05;1668;4451;17;1573.0;47773626
2021-09-05;969;2573;117;-699.0;47774595
2021-09-05;1535;4369;40;566.0;47776130
2021-09-06;8234;22448;171;6699.0;47784364
2021-09-06;6449;16223;55;-1785.0;47790813
2021-09-06;935;2451;1224;-5514.0;47791748
2021-09-06;10;4;0;-925.0;47791758
2021-09-06;4979;9990;4;4969.0;47796737
2021-09-06;36;45;0;-4943.0;47796773
2021-09-06;38589;101378;17254;38553.0;47835362
2021-09-06;4281;12880;595;-34308.0;47839643
2021-09-06;6249;18355;184;1968.0;47845892
2021-09-06;541;1095;6691;-5708.0;47846433
2021-09-06;1404;3601;509;863.0;47847837
2021-09-06;8;8;3;-1396.0;47847845
2021-09-06;383;853;5978;375.0;47848228
2021-09-06;4336;11747;62;3953.0;47852564
2021-09-06;744;1678;1778;-3592.0;47853308
2021-09-07;3;3;0;-741.0;47853311
2021-09-07;6384;18258;196;6381.0;47859695
2021-09-07;8221;21403;122;1837.0;47867916
2021-09-07;4455;11236;55;-3766.0;47872371
2021-09-07;468;989;5794;-3987.0;47872839
2021-09-07;880;1940;1870;412.0;47873719
2021-09-07;6597;15571;56;5717.0;47880316
2021-09-07;5647;9747;9;-950.0;47885963
2021-09-07;4613;13187;746;-1034.0;47890576
2021-09-07;5;8;1;-4608.0;47890581
2021-09-07;71;49;1;66.0;47890652
2021-09-07;751;1384;6881;680.0;47891403
2021-09-07;1562;4071;708;811.0;47892965
2021-09-07;40748;100678;17755;39186.0;47933713
2021-09-07;1091;2832;1316;-39657.0;47934804
2021-09-08;17;4;2;-1074.0;47934821
2021-09-08;1308;3342;657;1291.0;47936129
2021-09-08;7109;18354;137;5801.0;47943238
2021-09-08;5582;13650;50;-1527.0;47948820
2021-09-08;3994;11302;667;-1588.0;47952814
2021-09-08;689;1640;1565;-3305.0;47953503
2021-09-08;3767;9256;71;3078.0;47957270
2021-09-08;5765;16180;195;1998.0;47963035
2021-09-08;132;142;1;-5633.0;47963167
2021-09-08;905;2191;1167;773.0;47964072
2021-09-08;15045;32365;5;14140.0;47979117
2021-09-08;344;786;4966;-14701.0;47979461
2021-09-08;595;1250;6212;251.0;47980056
2021-09-08;17;6;3;-578.0;47980073
2021-09-08;45269;110468;15698;45252.0;48025342
2021-09-09;10;4;0;-45259.0;48025352
2021-09-09;3832;9673;56;3822.0;48029184
2021-09-09;421;1004;5136;-3411.0;48029605
2021-09-09;38283;90883;17224;37862.0;48067888
2021-09-09;4094;11730;892;-34189.0;48071982
2021-09-09;5735;13762;75;1641.0;48077717
2021-09-09;707;1418;6663;-5028.0;48078424
2021-09-09;1000;2493;1397;293.0;48079424
2021-09-09;1394;3623;820;394.0;48080818
2021-09-09;5602;15992;217;4208.0;48086420
2021-09-09;7;11;1;-5595.0;48086427
2021-09-09;7279;18812;155;7272.0;48093706
2021-09-09;7302;10495;4;23.0;48101008
2021-09-09;95;55;0;-7207.0;48101103
2021-09-09;805;1811;1808;710.0;48101908
2021-09-10;1661;3861;957;856.0;48103569
2021-09-10;13;15;1;-1648.0;48103582
2021-09-10;10667;17861;8;10654.0;48114249
2021-09-10;509;963;5382;-10158.0;48114758
2021-09-10;9;3;0;-500.0;48114767
2021-09-10;4517;11550;73;4508.0;48119284
2021-09-10;834;1500;7139;-3683.0;48120118
2021-09-10;92;61;0;-742.0;48120210
2021-09-10;827;1802;1948;735.0;48121037
2021-09-10;5122;14542;1222;4295.0;48126159
2021-09-10;6689;16238;64;1567.0;48132848
2021-09-10;8709;22818;192;2020.0;48141557
2021-09-10;7037;19981;258;-1672.0;48148594
2021-09-10;1126;2620;1530;-5911.0;48149720
2021-09-10;47812;113815;18774;46686.0;48197532
2021-09-11;2691;7963;36;-45121.0;48200223
2021-09-11;2820;9018;576;129.0;48203043
2021-09-11;4499;14398;36;1679.0;48207542
2021-09-11;7;6;0;-4492.0;48207549
2021-09-11;344;682;703;337.0;48207893
2021-09-11;33512;95526;6619;33168.0;48241405
2021-09-11;71;108;0;-33441.0;48241476
2021-09-11;215;363;1662;144.0;48241691
2021-09-11;461;1011;603;246.0;48242152
2021-09-11;4253;13572;161;3792.0;48246405
2021-09-11;5295;15224;104;1042.0;48251700
2021-09-11;733;1848;422;-4562.0;48252433
2021-09-11;11793;30734;7;11060.0;48264226
2021-09-11;323;598;2309;-11470.0;48264549
2021-09-11;7;1;0;-316.0;48264556
2021-09-12;65;188;99;58.0;48264621
2021-09-12;2063;5145;8;1998.0;48266684
2021-09-12;842;2695;52;-1221.0;48267526
2021-09-12;9;15;0;-833.0;48267535
2021-09-12;1022;2904;12;1013.0;48268557
2021-09-12;33;72;349;-989.0;48268590
2021-09-12;52;109;135;19.0;48268642
2021-09-12;1122;3449;44;1070.0;48269764
2021-09-12;6477;18513;1413;5355.0;48276241
2021-09-12;54;100;521;-6423.0;48276295
2021-09-12;487;1590;98;433.0;48276782
2021-09-12;1;2;0;-486.0;48276783
2021-09-12;123;334;73;122.0;48276906
2021-09-12;2;0;0;-121.0;48276908
2021-09-12;602;1910;22;600.0;48277510
2021-09-13;3341;7818;54;2739.0;48280851
2021-09-13;31668;70684;19133;28327.0;48312519
2021-09-13;497;1163;1918;-31171.0;48313016
2021-09-13;6522;14791;160;6025.0;48319538
2021-09-13;259;627;5429;-6263.0;48319797
2021-09-13;942;2521;733;683.0;48320739
2021-09-13;47;40;0;-895.0;48320786
2021-09-13;419;928;8476;372.0;48321205
2021-09-13;8;5;0;-411.0;48321213
2021-09-13;1;1;0;-7.0;48321214
2021-09-13;4780;10972;52;4779.0;48325994
2021-09-13;6543;9551;8;1763.0;48332537
2021-09-13;4621;12236;203;-1922.0;48337158
2021-09-13;3023;8384;694;-1598.0;48340181
2021-09-13;665;1647;1406;-2358.0;48340846
2021-09-14;1213;2845;1173;548.0;48342059
2021-09-14;7717;8923;9;6504.0;48349776
2021-09-14;6;9;0;-7711.0;48349782
2021-09-14;652;1411;2485;646.0;48350434
2021-09-14;34872;70396;25660;34220.0;48385306
2021-09-14;338;746;6273;-34534.0;48385644
2021-09-14;3;2;0;-335.0;48385647
2021-09-14;6610;14535;181;6607.0;48392257
2021-09-14;3415;7577;74;-3195.0;48395672
2021-09-14;4801;10091;60;1386.0;48400473
2021-09-14;65;44;2;-4736.0;48400538
2021-09-14;696;1146;11925;631.0;48401234
2021-09-14;3560;9016;1334;2864.0;48404794
2021-09-14;834;1997;1902;-2726.0;48405628
2021-09-14;4962;12054;242;4128.0;48410590
2021-09-15;12;12;0;-4950.0;48410602
2021-09-15;5873;13463;121;5861.0;48416475
2021-09-15;37055;88416;23412;31182.0;48453530
2021-09-15;4546;11654;200;-32509.0;48458076
2021-09-15;3126;6748;62;-1420.0;48461202
2021-09-15;298;687;6142;-2828.0;48461500
2021-09-15;12263;31088;14;11965.0;48473763
2021-09-15;79;108;1;-12184.0;48473842
2021-09-15;3267;8069;1102;3188.0;48477109
2021-09-15;1096;2510;875;-2171.0;48478205
2021-09-15;4661;10042;72;3565.0;48482866
2021-09-15;701;1708;1625;-3960.0;48483567
2021-09-15;557;1047;11155;-144.0;48484124
2021-09-15;571;1276;2043;14.0;48484695
2021-09-15;5;4;0;-566.0;48484700
2021-09-16;2871;7561;1266;2866.0;48487571
2021-09-16;79;46;0;-2792.0;48487650
2021-09-16;748;1744;1892;669.0;48488398
2021-09-16;3929;10211;189;3181.0;48492327
2021-09-16;31544;60560;24549;27615.0;48523871
2021-09-16;304;701;5668;-31240.0;48524175
2021-09-16;9491;8896;6;9187.0;48533666
2021-09-16;2702;6030;50;-6789.0;48536368
2021-09-16;6;11;0;-2696.0;48536374
2021-09-16;4946;12117;107;4940.0;48541320
2021-09-16;4108;8467;50;-838.0;48545428
2021-09-16;999;2385;1218;-3109.0;48546427
2021-09-16;725;1066;11780;-274.0;48547152
2021-09-16;632;1321;2323;-93.0;48547784
2021-09-16;4;4;0;-628.0;48547788
2021-09-17;782;1259;11117;778.0;48548570
2021-09-17;37217;83098;24655;36435.0;48585787
2021-09-17;1;2;0;-37216.0;48585788
2021-09-17;4801;11337;61;4800.0;48590589
2021-09-17;6;6;1;-4795.0;48590595
2021-09-17;4843;13671;237;4837.0;48595438
2021-09-17;377;774;5446;-4466.0;48595815
2021-09-17;678;1375;2350;301.0;48596493
2021-09-17;6151;15482;155;5473.0;48602644
2021-09-17;3619;10166;1892;-2532.0;48606263
2021-09-17;822;1864;1973;-2797.0;48607085
2021-09-17;10874;16580;15;10052.0;48617959
2021-09-17;67;92;1;-10807.0;48618026
2021-09-17;1110;2855;1352;1043.0;48619136
2021-09-17;3086;7635;55;1976.0;48622222
2021-09-18;561;1432;513;-2525.0;48622783
2021-09-18;4;7;0;-557.0;48622787
2021-09-18;3697;10902;85;3693.0;48626484
2021-09-18;48;97;0;-3649.0;48626532
2021-09-18;2;1;0;-46.0;48626534
2021-09-18;8338;29312;33;8336.0;48634872
2021-09-18;156;352;1746;-8182.0;48635028
2021-09-18;24162;76080;7931;24006.0;48659190
2021-09-18;2084;6394;772;-22078.0;48661274
2021-09-18;3105;9641;137;1021.0;48664379
2021-09-18;1949;5555;32;-1156.0;48666328
2021-09-18;257;587;764;-1692.0;48666585
2021-09-18;323;818;641;66.0;48666908
2021-09-18;3360;10493;40;3037.0;48670268
2021-09-18;278;489;3168;-3082.0;48670546
2021-09-19;0;1;0;-278.0;48670546
2021-09-19;79;241;76;79.0;48670625
2021-09-19;27;60;231;-52.0;48670652
2021-09-19;40;92;131;13.0;48670692
2021-09-19;537;1856;24;497.0;48671229
2021-09-19;605;1940;10;68.0;48671834
2021-09-19;0;0;0;-605.0;48671834
2021-09-19;32;78;465;32.0;48671866
2021-09-19;1;17;0;-31.0;48671867
2021-09-19;56;133;94;55.0;48671923
2021-09-19;390;1240;18;334.0;48672313
2021-09-19;330;998;91;-60.0;48672643
2021-09-19;4014;13373;1179;3684.0;48676657
2021-09-19;715;2377;35;-3299.0;48677372
2021-09-19;1202;4340;4;487.0;48678574
2021-09-20;2;0;0;-1200.0;48678576
2021-09-20;399;753;9989;397.0;48678975
2021-09-20;22227;50325;20928;21828.0;48701202
2021-09-20;6061;8682;11;-16166.0;48707263
2021-09-20;57;53;0;-6004.0;48707320
2021-09-20;4061;9959;111;4004.0;48711381
2021-09-20;605;1785;793;-3456.0;48711986
2021-09-20;365;864;2016;-240.0;48712351
2021-09-20;222;500;5429;-143.0;48712573
2021-09-20;2853;8177;128;2631.0;48715426
2021-09-20;2147;5270;52;-706.0;48717573
2021-09-20;3066;7460;52;919.0;48720639
2021-09-20;488;1205;1492;-2578.0;48721127
2021-09-20;10;8;0;-478.0;48721137
2021-09-20;1891;5609;855;1881.0;48723028
2021-09-21;572;1464;1949;-1319.0;48723600
2021-09-21;2649;8352;216;2077.0;48726249
2021-09-21;508;932;12049;-2141.0;48726757
2021-09-21;5;0;0;-503.0;48726762
2021-09-21;811;2058;1257;806.0;48727573
2021-09-21;7160;8503;9;6349.0;48734733
2021-09-21;2012;6228;1274;-5148.0;48736745
2021-09-21;3650;9937;116;1638.0;48740395
2021-09-21;2866;7068;50;-784.0;48743261
2021-09-21;22822;51471;24821;19956.0;48766083
2021-09-21;246;616;5458;-22576.0;48766329
2021-09-21;61;48;0;-185.0;48766390
2021-09-21;435;1081;2393;374.0;48766825
2021-09-21;1844;5173;50;1409.0;48768669
2021-09-21;3;11;0;-1841.0;48768672
2021-09-22;5;2;0;2.0;48768677
2021-09-22;229;568;5214;224.0;48768906
2021-09-22;1931;5876;1044;1702.0;48770837
2021-09-22;51;175;0;-1880.0;48770888
2021-09-22;362;996;2142;311.0;48771250
2021-09-22;685;1855;984;323.0;48771935
2021-09-22;2679;8701;184;1994.0;48774614
2021-09-22;3;6;0;-2676.0;48774617
2021-09-22;1958;5133;52;1955.0;48776575
2021-09-22;523;1304;1755;-1435.0;48777098
2021-09-22;8762;30837;21;8239.0;48785860
2021-09-22;24049;74078;22005;15287.0;48809909
2021-09-22;464;903;10439;-23585.0;48810373
2021-09-22;3462;9919;108;2998.0;48813835
2021-09-22;2935;7803;62;-527.0;48816770
2021-09-23;525;1325;1986;-2410.0;48817295
2021-09-23;642;1865;1347;117.0;48817937
2021-09-23;526;991;11416;-116.0;48818463
2021-09-23;2617;6711;50;2091.0;48821080
2021-09-23;72;50;0;-2545.0;48821152
2021-09-23;3166;8944;126;3094.0;48824318
2021-09-23;6;3;0;-3160.0;48824324
2021-09-23;1726;4378;48;1720.0;48826050
2021-09-23;2496;7418;193;770.0;48828546
2021-09-23;1;4;0;-2495.0;48828547
2021-09-23;247;552;5214;246.0;48828794
2021-09-23;1818;5592;1357;1571.0;48830612
2021-09-23;21432;46852;24413;19614.0;48852044
2021-09-23;7171;7991;14;-14261.0;48859215
2021-09-23;419;1028;2662;-6752.0;48859634
2021-09-24;11;12;0;-408.0;48859645
2021-09-24;26091;68327;24896;26080.0;48885736
2021-09-24;3254;9162;76;-22837.0;48888990
2021-09-24;560;1055;10340;-2694.0;48889550
2021-09-24;1;3;0;-559.0;48889551
2021-09-24;590;1595;2216;589.0;48890141
2021-09-24;2172;6195;68;1582.0;48892313
2021-09-24;3320;10847;233;1148.0;48895633
2021-09-24;7973;14889;21;4653.0;48903606
2021-09-24;2486;7788;1883;-5487.0;48906092
2021-09-24;283;664;5778;-2203.0;48906375
2021-09-24;54;95;0;-229.0;48906429
2021-09-24;516;1158;2647;462.0;48906945
2021-09-24;835;2283;1472;319.0;48907780
2021-09-24;4036;12581;162;3201.0;48911816
2021-09-25;220;479;881;-3816.0;48912036
2021-09-25;0;1;0;-220.0;48912036
2021-09-25;2807;8585;107;2807.0;48914843
2021-09-25;3;6;0;-2804.0;48914846
2021-09-25;289;710;772;286.0;48915135
2021-09-25;17739;61712;8259;17450.0;48932874
2021-09-25;1521;4847;780;-16218.0;48934395
2021-09-25;122;292;1927;-1399.0;48934517
2021-09-25;215;472;2987;93.0;48934732
2021-09-25;5909;24738;29;5694.0;48940641
2021-09-25;2452;8368;63;-3457.0;48943093
2021-09-25;2200;7452;126;-252.0;48945293
2021-09-25;431;1170;535;-1769.0;48945724
2021-09-25;34;120;0;-397.0;48945758
2021-09-25;1536;4472;52;1502.0;48947294
2021-09-26;2836;9789;1053;1300.0;48950130
2021-09-26;408;1354;37;-2428.0;48950538
2021-09-26;1;0;0;-407.0;48950539
2021-09-26;848;3317;2;847.0;48951387
2021-09-26;70;170;55;-778.0;48951457
2021-09-26;30;80;142;-40.0;48951487
2021-09-26;16;53;230;-14.0;48951503
2021-09-26;3;5;0;-13.0;48951506
2021-09-26;218;777;86;215.0;48951724
2021-09-26;6;23;0;-212.0;48951730
2021-09-26;501;1592;27;495.0;48952231
2021-09-26;273;834;12;-228.0;48952504
2021-09-26;390;1404;13;117.0;48952894
2021-09-26;33;73;352;-357.0;48952927
2021-09-26;39;107;97;6.0;48952966
2021-09-27;1679;4257;62;1640.0;48954645
2021-09-27;298;747;2273;-1381.0;48954943
2021-09-27;4;2;0;-294.0;48954947
2021-09-27;2236;6084;57;2232.0;48957183
2021-09-27;169;393;5682;-2067.0;48957352
2021-09-27;315;645;8608;146.0;48957667
2021-09-27;2090;6365;154;1775.0;48959757
2021-09-27;16898;40816;20322;14808.0;48976655
2021-09-27;4680;6914;8;-12218.0;48981335
2021-09-27;1477;4383;809;-3203.0;48982812
2021-09-27;514;1476;825;-963.0;48983326
2021-09-27;29;51;0;-485.0;48983355
2021-09-27;385;1000;1720;356.0;48983740
2021-09-27;1;1;0;-384.0;48983741
2021-09-27;3021;8498;124;3020.0;48986762
2021-09-28;419;795;9980;-2602.0;48987181
2021-09-28;1690;4486;1197;1271.0;48988871
2021-09-28;4;5;1;-1686.0;48988875
2021-09-28;2;2;0;-2.0;48988877
2021-09-28;2221;5970;179;2219.0;48991098
2021-09-28;455;1138;1910;-1766.0;48991553
2021-09-28;3065;7384;138;2610.0;48994618
2021-09-28;2451;5530;63;-614.0;48997069
2021-09-28;50;45;0;-2401.0;48997119
2021-09-28;18267;38182;22828;18217.0;49015386
2021-09-28;629;1557;1185;-17638.0;49016015
2021-09-28;229;471;5519;-400.0;49016244
2021-09-28;1612;3948;60;1383.0;49017856
2021-09-28;387;922;2586;-1225.0;49018243
2021-09-28;5053;5929;9;4666.0;49023296
2021-09-29;1851;3839;83;-3202.0;49025147
2021-09-29;631;1361;1125;-1220.0;49025778
2021-09-29;2;4;0;-629.0;49025780
2021-09-29;5;3;0;3.0;49025785
2021-09-29;390;723;9681;385.0;49026175
2021-09-29;505;972;1942;115.0;49026680
2021-09-29;7658;19445;18;7153.0;49034338
2021-09-29;1763;4288;1118;-5895.0;49036101
2021-09-29;224;457;5738;-1539.0;49036325
2021-09-29;43;116;0;-181.0;49036368
2021-09-29;2679;5733;53;2636.0;49039047
2021-09-29;2571;6333;208;-108.0;49041618
2021-09-29;22081;51518;22719;19510.0;49063699
2021-09-29;3392;7468;127;-18689.0;49067091
2021-09-29;367;776;2626;-3025.0;49067458
2021-09-30;1626;3424;51;1259.0;49069084
2021-09-30;36;62;0;-1590.0;49069120
2021-09-30;2315;5627;214;2279.0;49071435
2021-09-30;492;1102;2151;-1823.0;49071927
2021-09-30;393;763;10022;-99.0;49072320
2021-09-30;1719;4110;1457;1326.0;49074039
2021-09-30;2966;6809;150;1247.0;49077005
2021-09-30;353;876;2843;-2613.0;49077358
2021-09-30;224;465;5477;-129.0;49077582
2021-09-30;18063;36224;23821;17839.0;49095645
2021-09-30;1;5;0;-18062.0;49095646
2021-09-30;656;1459;1379;655.0;49096302
2021-09-30;4904;6700;15;4248.0;49101206
2021-09-30;4;2;0;-4900.0;49101210
2021-09-30;2374;4820;62;2370.0;49103584
2021-10-01;6868;11996;20;4494.0;49110452
2021-10-01;3103;5515;2142;-3765.0;49113555
2021-10-01;68;90;0;-3035.0;49113623
2021-10-01;969;1660;1563;901.0;49114592
2021-10-01;4671;7744;284;3702.0;49119263
2021-10-01;467;881;10958;-4204.0;49119730
2021-10-01;4392;6717;95;3925.0;49124122
2021-10-01;663;1208;2679;-3729.0;49124785
2021-10-01;263;516;6897;-400.0;49125048
2021-10-01;13;6;0;-250.0;49125061
2021-10-01;3371;4743;88;3358.0;49128432
2021-10-01;31758;51318;28420;28387.0;49160190
2021-10-01;6398;9371;243;-25360.0;49166588
2021-10-01;9;10;0;-6389.0;49166597
2021-10-01;503;861;3451;494.0;49167100
2021-10-02;2459;5698;48;1956.0;49169559
2021-10-02;113;216;2560;-2346.0;49169672
2021-10-02;1739;3137;60;1626.0;49171411
2021-10-02;7130;15360;26;5391.0;49178541
2021-10-02;2;5;0;-7128.0;49178543
2021-10-02;1603;3483;929;1601.0;49180146
2021-10-02;468;827;665;-1135.0;49180614
2021-10-02;4;0;0;-464.0;49180618
2021-10-02;3181;6176;142;3177.0;49183799
2021-10-02;221;410;1281;-2960.0;49184020
2021-10-02;20071;41479;10629;19850.0;49204091
2021-10-02;293;520;989;-19778.0;49204384
2021-10-02;2643;5215;175;2350.0;49207027
2021-10-02;54;79;0;-2589.0;49207081
2021-10-02;161;353;3754;107.0;49207242
2021-10-03;24;49;161;-137.0;49207266
2021-10-03;220;535;10;196.0;49207486
2021-10-03;43;82;148;-177.0;49207529
2021-10-03;0;0;0;-43.0;49207529
2021-10-03;14;53;338;14.0;49207543
2021-10-03;395;915;11;381.0;49207938
2021-10-03;205;464;96;-190.0;49208143
2021-10-03;14;33;256;-191.0;49208157
2021-10-03;322;753;43;308.0;49208479
2021-10-03;12;22;0;-310.0;49208491
2021-10-03;53;107;80;41.0;49208544
2021-10-03;2708;6012;1166;2655.0;49211252
2021-10-03;957;1870;5;-1751.0;49212209
2021-10-03;447;1128;18;-510.0;49212656
2021-10-03;2;1;0;-445.0;49212658
2021-10-04;3;2;0;1.0;49212661
2021-10-04;18188;30046;24571;18185.0;49230849
2021-10-04;2710;4611;219;-15478.0;49233559
2021-10-04;2147;3176;63;-563.0;49235706
2021-10-04;438;687;2115;-1709.0;49236144
2021-10-04;26;42;0;-412.0;49236170
2021-10-04;319;564;3376;293.0;49236489
2021-10-04;264;481;9728;-55.0;49236753
2021-10-04;2818;4313;61;2554.0;49239571
2021-10-04;1752;3016;995;-1066.0;49241323
2021-10-04;6;5;1;-1746.0;49241329
2021-10-04;3036;5832;17;3030.0;49244365
2021-10-04;184;347;6859;-2852.0;49244549
2021-10-04;3938;5959;139;3754.0;49248487
2021-10-04;547;1011;998;-3391.0;49249034
2021-10-05;336;658;3662;-211.0;49249370
2021-10-05;2493;4580;272;2157.0;49251863
2021-10-05;230;366;7263;-2263.0;49252093
2021-10-05;3;4;0;-227.0;49252096
2021-10-05;431;784;2564;428.0;49252527
2021-10-05;660;1170;1460;229.0;49253187
2021-10-05;4;2;0;-656.0;49253191
2021-10-05;1689;3283;1447;1685.0;49254880
2021-10-05;332;623;11156;-1357.0;49255212
2021-10-05;2580;4246;66;2248.0;49257792
2021-10-05;1911;3012;76;-669.0;49259703
2021-10-05;17288;30788;28176;15377.0;49276991
2021-10-05;3067;6316;25;-14221.0;49280058
2021-10-05;32;45;0;-3035.0;49280090
2021-10-05;3520;5699;185;3488.0;49283610
2021-10-06;341;622;11713;-3179.0;49283951
2021-10-06;2685;4737;67;2344.0;49286636
2021-10-06;1840;3480;1314;-845.0;49288476
2021-10-06;21467;39648;29618;19627.0;49309943
2021-10-06;460;829;2517;-21007.0;49310403
2021-10-06;4;6;0;-456.0;49310407
2021-10-06;214;382;8058;210.0;49310621
2021-10-06;3314;5998;199;3100.0;49313935
2021-10-06;7128;13747;31;3814.0;49321063
2021-10-06;611;1123;1368;-6517.0;49321674
2021-10-06;6;0;0;-605.0;49321680
2021-10-06;344;611;3979;338.0;49322024
2021-10-06;1860;3130;77;1516.0;49323884
2021-10-06;2603;4883;293;743.0;49326487
2021-10-06;57;100;2;-2546.0;49326544
2021-10-07;2716;4878;256;2659.0;49329260
2021-10-07;191;315;7170;-2525.0;49329451
2021-10-07;14953;29156;29341;14762.0;49344404
2021-10-07;349;679;11361;-14604.0;49344753
2021-10-07;0;2;1;-349.0;49344753
2021-10-07;1530;2602;109;1530.0;49346283
2021-10-07;6;4;0;-1524.0;49346289
2021-10-07;2206;3854;88;2200.0;49348495
2021-10-07;351;642;3862;-1855.0;49348846
2021-10-07;1586;2940;1788;1235.0;49350432
2021-10-07;460;794;2752;-1126.0;49350892
2021-10-07;30;64;0;-430.0;49350922
2021-10-07;2915;7366;10;2885.0;49353837
2021-10-07;2058;3986;365;-857.0;49355895
2021-10-07;555;1030;1578;-1503.0;49356450
2021-10-08;514;782;5250;-41.0;49356964
2021-10-08;833;1428;2044;319.0;49357797
2021-10-08;3495;5583;90;2662.0;49361292
2021-10-08;2534;3860;120;-961.0;49363826
2021-10-08;71;80;0;-2463.0;49363897
2021-10-08;600;989;3360;529.0;49364497
2021-10-08;24720;44250;37228;24120.0;49389217
2021-10-08;5089;11824;26;-19631.0;49394306
2021-10-08;4675;7576;371;-414.0;49398981
2021-10-08;3647;6255;571;-1028.0;49402628
2021-10-08;13;1;0;-3634.0;49402641
2021-10-08;270;439;9188;257.0;49402911
2021-10-08;5;3;0;-265.0;49402916
2021-10-08;2525;4615;2585;2520.0;49405441
2021-10-08;449;815;13623;-2076.0;49405890
2021-10-09;1468;2766;1213;1019.0;49407358
2021-10-09;102;222;3497;-1366.0;49407460
2021-10-09;2141;4172;340;2039.0;49409601
2021-10-09;2616;5004;212;475.0;49412217
2021-10-09;326;696;897;-2290.0;49412543
2021-10-09;2382;4691;78;2056.0;49414925
2021-10-09;2;2;0;-2380.0;49414927
2021-10-09;195;374;2187;193.0;49415122
2021-10-09;5492;10676;21;5297.0;49420614
2021-10-09;273;409;1362;-5219.0;49420887
2021-10-09;16602;32070;14997;16329.0;49437489
2021-10-09;1405;2699;85;-15197.0;49438894
2021-10-09;0;0;0;-1405.0;49438894
2021-10-09;30;55;0;30.0;49438924
2021-10-09;170;304;5105;140.0;49439094
2021-10-10;581;1024;5;411.0;49439675
2021-10-10;320;610;15;-261.0;49439995
2021-10-10;2445;4127;1524;2125.0;49442440
2021-10-10;11;9;0;-2434.0;49442451
2021-10-10;66;87;135;55.0;49442517
2021-10-10;218;360;135;152.0;49442735
2021-10-10;17;31;288;-201.0;49442752
2021-10-10;31;69;169;14.0;49442783
2021-10-10;353;575;60;322.0;49443136
2021-10-10;294;429;22;-59.0;49443430
2021-10-10;33;42;404;-261.0;49443463
2021-10-10;23;55;249;-10.0;49443486
2021-10-10;2;0;0;-21.0;49443488
2021-10-10;2;2;0;0.0;49443490
2021-10-10;494;834;42;492.0;49443984
2021-10-11;235;469;10213;-259.0;49444219
2021-10-11;339;477;4129;104.0;49444558
2021-10-11;403;600;2524;64.0;49444961
2021-10-11;3218;4669;288;2815.0;49448179
2021-10-11;2346;5682;20;-872.0;49450525
2021-10-11;15214;24993;27948;12868.0;49465739
2021-10-11;196;295;7342;-15018.0;49465935
2021-10-11;6;7;1;-190.0;49465941
2021-10-11;25;31;0;19.0;49465966
2021-10-11;6;3;0;-19.0;49465972
2021-10-11;2246;3482;417;2240.0;49468218
2021-10-11;1454;2348;1484;-792.0;49469672
2021-10-11;498;761;1316;-956.0;49470170
2021-10-11;2455;3626;95;1957.0;49472625
2021-10-11;1787;2543;119;-668.0;49474412
2021-10-12;15478;25110;32631;13691.0;49489890
2021-10-12;23;60;0;-15455.0;49489913
2021-10-12;348;575;4702;325.0;49490261
2021-10-12;2389;3286;105;2041.0;49492650
2021-10-12;4;2;0;-2385.0;49492654
2021-10-12;1683;2505;2163;1679.0;49494337
2021-10-12;1686;2228;143;3.0;49496023
2021-10-12;494;646;3148;-1192.0;49496517
2021-10-12;3007;4324;374;2513.0;49499524
2021-10-12;229;273;7798;-2778.0;49499753
2021-10-12;2;8;0;-227.0;49499755
2021-10-12;2475;6447;17;2473.0;49502230
2021-10-12;2212;3301;540;-263.0;49504442
2021-10-12;622;912;1833;-1590.0;49505064
2021-10-12;304;543;11808;-318.0;49505368
2021-10-13;5509;10082;33;5205.0;49510877
2021-10-13;657;887;1790;-4852.0;49511534
2021-10-13;390;505;5061;-267.0;49511924
2021-10-13;30;65;1;-360.0;49511954
2021-10-13;183;296;8592;153.0;49512137
2021-10-13;3;2;0;-180.0;49512140
2021-10-13;2979;3947;116;2976.0;49515119
2021-10-13;2476;3702;574;-503.0;49517595
2021-10-13;19997;30719;34531;17521.0;49537592
2021-10-13;5;3;0;-19992.0;49537597
2021-10-13;1754;2541;2191;1749.0;49539351
2021-10-13;1919;2651;156;165.0;49541270
2021-10-13;3332;4845;403;1413.0;49544602
2021-10-13;475;695;3183;-2857.0;49545077
2021-10-13;285;498;12431;-190.0;49545362
2021-10-14;1544;2277;2347;1259.0;49546906
2021-10-14;336;485;4571;-1208.0;49547242
2021-10-14;2135;3112;597;1799.0;49549377
2021-10-14;592;800;1928;-1543.0;49549969
2021-10-14;2276;6357;10;1684.0;49552245
2021-10-14;8;4;1;-2268.0;49552253
2021-10-14;2942;4228;441;2934.0;49555195
2021-10-14;315;588;11263;-2627.0;49555510
2021-10-14;205;288;7201;-110.0;49555715
2021-10-14;1650;2123;133;1445.0;49557365
2021-10-14;2328;3092;95;678.0;49559693
2021-10-14;27;55;0;-2301.0;49559720
2021-10-14;14831;24073;31658;14804.0;49574551
2021-10-14;2;1;0;-14829.0;49574553
2021-10-14;471;663;3071;469.0;49575024
2021-10-15;2428;3077;196;1957.0;49577452
2021-10-15;437;683;14942;-1991.0;49577889
2021-10-15;781;1093;2850;344.0;49578670
2021-10-15;1;2;0;-780.0;49578671
2021-10-15;4369;5918;562;4368.0;49583040
2021-10-15;8;10;1;-4361.0;49583048
2021-10-15;4083;9378;25;4075.0;49587131
2021-10-15;529;785;4523;-3554.0;49587660
2021-10-15;231;380;10189;-298.0;49587891
2021-10-15;2400;3443;3557;2169.0;49590291
2021-10-15;3389;4614;123;989.0;49593680
2021-10-15;37;67;0;-3352.0;49593717
2021-10-15;22389;34770;44681;22352.0;49616106
2021-10-15;3231;4658;890;-19158.0;49619337
2021-10-15;465;662;6823;-2766.0;49619802
2021-10-16;1505;2146;89;1040.0;49621307
2021-10-16;111;165;3739;-1394.0;49621418
2021-10-16;2354;3420;88;2243.0;49623772
2021-10-16;15633;23584;17213;13279.0;49639405
2021-10-16;145;259;5345;-15488.0;49639550
2021-10-16;2;0;0;-143.0;49639552
2021-10-16;229;339;1769;227.0;49639781
2021-10-16;1383;2114;1634;1154.0;49641164
2021-10-16;3;0;0;-1380.0;49641167
2021-10-16;2177;3065;411;2174.0;49643344
2021-10-16;166;262;2772;-2011.0;49643510
2021-10-16;2850;3941;275;2684.0;49646360
2021-10-16;374;559;1068;-2476.0;49646734
2021-10-16;4311;7268;22;3937.0;49651045
2021-10-16;23;46;1;-4288.0;49651068
2021-10-17;444;591;50;421.0;49651512
2021-10-17;2;8;0;-442.0;49651514
2021-10-17;22;40;274;20.0;49651536
2021-10-17;34;57;151;12.0;49651570
2021-10-17;271;336;18;237.0;49651841
2021-10-17;2072;2973;1578;1801.0;49653913
2021-10-17;319;449;17;-1753.0;49654232
2021-10-17;0;0;0;-319.0;49654232
2021-10-17;16;32;421;16.0;49654248
2021-10-17;388;675;6;372.0;49654636
2021-10-17;46;91;120;-342.0;49654682
2021-10-17;2;1;0;-44.0;49654684
2021-10-17;196;254;178;194.0;49654880
2021-10-17;23;19;275;-173.0;49654903
2021-10-17;309;420;68;286.0;49655212
2021-10-18;3157;4097;415;2848.0;49658369
2021-10-18;10;4;0;-3147.0;49658379
2021-10-18;132;212;7450;122.0;49658511
2021-10-18;4;9;1;-128.0;49658515
2021-10-18;1492;1969;1873;1488.0;49660007
2021-10-18;1830;2112;172;338.0;49661837
2021-10-18;207;353;10227;-1623.0;49662044
2021-10-18;2187;2859;581;1980.0;49664231
2021-10-18;373;463;3188;-1814.0;49664604
2021-10-18;14672;21364;30905;14299.0;49679276
2021-10-18;269;352;5467;-14403.0;49679545
2021-10-18;28;55;1;-241.0;49679573
2021-10-18;2480;3123;110;2452.0;49682053
2021-10-18;489;605;1399;-1991.0;49682542
2021-10-18;2014;5151;19;1525.0;49684556
2021-10-19;409;558;3614;-1605.0;49684965
2021-10-19;1434;1973;2348;1025.0;49686399
2021-10-19;2017;2850;725;583.0;49688416
2021-10-19;314;494;5850;-1703.0;49688730
2021-10-19;531;706;1868;217.0;49689261
2021-10-19;4;4;1;-527.0;49689265
2021-10-19;1847;5561;15;1843.0;49691112
2021-10-19;189;260;8161;-1658.0;49691301
2021-10-19;20;85;0;-169.0;49691321
2021-10-19;4;4;0;-16.0;49691325
2021-10-19;2190;2899;115;2186.0;49693515
2021-10-19;272;454;11599;-1918.0;49693787
2021-10-19;2717;3877;500;2445.0;49696504
2021-10-19;13525;21848;34958;10808.0;49710029
2021-10-19;1577;2123;162;-11948.0;49711606
2021-10-20;38;57;0;-1539.0;49711644
2021-10-20;541;712;2259;503.0;49712185
2021-10-20;295;449;14277;-246.0;49712480
2021-10-20;3131;4083;557;2836.0;49715611
2021-10-20;2408;3109;885;-723.0;49718019
2021-10-20;187;284;10571;-2221.0;49718206
2021-10-20;4249;8092;25;4062.0;49722455
2021-10-20;413;601;4552;-3836.0;49722868
2021-10-20;1574;2223;2756;1161.0;49724442
2021-10-20;17373;25677;44120;15799.0;49741815
2021-10-20;310;449;7843;-17063.0;49742125
2021-10-20;1729;2246;249;1419.0;49743854
2021-10-20;2489;3364;145;760.0;49746343
2021-10-20;5;5;1;-2484.0;49746348
2021-10-20;4;3;0;-1.0;49746352
2021-10-21;201;290;8553;197.0;49746553
2021-10-21;2643;3614;637;2442.0;49749196
2021-10-21;1429;1936;2787;-1214.0;49750625
2021-10-21;12892;21001;38228;11463.0;49763517
2021-10-21;14;62;1;-12878.0;49763531
2021-10-21;327;425;6656;313.0;49763858
2021-10-21;4;6;1;-323.0;49763862
2021-10-21;4;2;0;0.0;49763866
2021-10-21;279;472;12038;275.0;49764145
2021-10-21;475;660;2257;196.0;49764620
2021-10-21;1940;2700;899;1465.0;49766560
2021-10-21;385;542;3950;-1555.0;49766945
2021-10-21;1399;1903;249;1014.0;49768344
2021-10-21;1969;2865;172;570.0;49770313
2021-10-21;1823;5524;28;-146.0;49772136
2021-10-22;537;681;5290;-1286.0;49772673
2021-10-22;201;336;10940;-336.0;49772874
2021-10-22;2104;2977;3806;1903.0;49774978
2021-10-22;2805;3967;1067;701.0;49777783
2021-10-22;19118;29611;48518;16313.0;49796901
2021-10-22;23;53;0;-19095.0;49796924
2021-10-22;336;531;8815;313.0;49797260
2021-10-22;4;6;1;-332.0;49797264
2021-10-22;2879;3855;176;2875.0;49800143
2021-10-22;2119;2673;239;-760.0;49802262
2021-10-22;2;4;0;-2117.0;49802264
2021-10-22;3864;5084;713;3862.0;49806128
2021-10-22;335;571;14571;-3529.0;49806463
2021-10-22;647;963;2861;312.0;49807110
2021-10-22;3262;7910;39;2615.0;49810372
2021-10-23;192;347;2401;-3070.0;49810564
2021-10-23;1222;1776;1992;1030.0;49811786
2021-10-23;89;148;4246;-1133.0;49811875
2021-10-23;300;539;1384;211.0;49812175
2021-10-23;0;1;0;-300.0;49812175
2021-10-23;13500;21392;21232;13500.0;49825675
2021-10-23;2493;3597;387;-11007.0;49828168
2021-10-23;156;236;4113;-2337.0;49828324
2021-10-23;1319;1922;159;1163.0;49829643
2021-10-23;22;51;0;-1297.0;49829665
2021-10-23;1919;2867;567;1897.0;49831584
2021-10-23;3487;6695;32;1568.0;49835071
2021-10-23;145;221;5804;-3342.0;49835216
2021-10-23;2;1;0;-143.0;49835218
2021-10-23;2154;2991;147;2152.0;49837372
2021-10-24;24;64;138;-2130.0;49837396
2021-10-24;20;51;220;-4.0;49837416
2021-10-24;286;506;54;266.0;49837702
2021-10-24;20;24;337;-266.0;49837722
2021-10-24;2;5;1;-18.0;49837724
2021-10-24;205;362;86;203.0;49837929
2021-10-24;9;17;254;-196.0;49837938
2021-10-24;1460;2595;1700;1451.0;49839398
2021-10-24;169;262;43;-1291.0;49839567
2021-10-24;308;645;4;139.0;49839875
2021-10-24;1;0;0;-307.0;49839876
2021-10-24;14;25;369;13.0;49839890
2021-10-24;0;1;0;-14.0;49839890
2021-10-24;145;234;173;145.0;49840035
2021-10-24;257;399;21;112.0;49840292
2021-10-25;1386;1876;209;1129.0;49841678
2021-10-25;2978;3786;34;1592.0;49844656
2021-10-25;2494;3447;512;-484.0;49847150
2021-10-25;371;537;1863;-2123.0;49847521
2021-10-25;1;4;0;-370.0;49847522
2021-10-25;2;5;0;1.0;49847524
2021-10-25;28;32;0;26.0;49847552
2021-10-25;12807;17804;37688;12779.0;49860359
2021-10-25;196;361;8417;-12611.0;49860555
2021-10-25;322;438;4422;126.0;49860877
2021-10-25;1946;2666;134;1624.0;49862823
2021-10-25;1098;1609;2300;-848.0;49863921
2021-10-25;1692;2549;754;594.0;49865613
2021-10-25;141;211;8430;-1551.0;49865754
2021-10-25;152;283;10613;11.0;49865906
2021-10-26;1593;2297;784;1441.0;49867499
2021-10-26;208;360;11493;-1385.0;49867707
2021-10-26;3;2;0;-205.0;49867710
2021-10-26;1768;2355;158;1765.0;49869478
2021-10-26;2341;3014;21;573.0;49871819
2021-10-26;17;23;1;-2324.0;49871836
2021-10-26;11551;16067;39874;11534.0;49883387
2021-10-26;301;424;4565;-11250.0;49883688
2021-10-26;153;225;8820;-148.0;49883841
2021-10-26;1175;1734;253;1022.0;49885016
2021-10-26;2205;3112;571;1030.0;49887221
2021-10-26;265;376;8340;-1940.0;49887486
2021-10-26;378;601;2215;113.0;49887864
2021-10-26;1142;1542;2653;764.0;49889006
2021-10-26;2;2;0;-1140.0;49889008
2021-10-27;1385;1911;3078;1383.0;49890393
2021-10-27;14849;21939;50064;13464.0;49905242
2021-10-27;34;44;0;-14815.0;49905276
2021-10-27;2606;3712;674;2572.0;49907882
2021-10-27;5;4;0;-2601.0;49907887
2021-10-27;291;414;11310;286.0;49908178
2021-10-27;451;658;2681;160.0;49908629
2021-10-27;212;412;14189;-239.0;49908841
2021-10-27;1950;2798;975;1738.0;49910791
2021-10-27;1513;2057;292;-437.0;49912304
2021-10-27;2277;2972;177;764.0;49914581
2021-10-27;147;250;10969;-2130.0;49914728
2021-10-27;359;506;5675;212.0;49915087
2021-10-27;2;1;0;-357.0;49915089
2021-10-27;3617;6200;44;3615.0;49918706
2021-10-28;3;1;0;-3614.0;49918709
2021-10-28;1598;2163;907;1595.0;49920307
2021-10-28;241;352;8936;-1357.0;49920548
2021-10-28;2153;2973;685;1912.0;49922701
2021-10-28;1156;1622;266;-997.0;49923857
2021-10-28;1189;1650;3058;33.0;49925046
2021-10-28;141;208;8231;-1048.0;49925187
2021-10-28;11520;15378;40606;11379.0;49936707
2021-10-28;403;575;2360;-11117.0;49937110
2021-10-28;20;20;1;-383.0;49937130
2021-10-28;2318;2712;15;2298.0;49939448
2021-10-28;2;4;0;-2316.0;49939450
2021-10-28;1730;2257;162;1728.0;49941180
2021-10-28;300;461;4713;-1430.0;49941480
2021-10-28;266;380;11272;-34.0;49941746
2021-10-29;1;2;0;-265.0;49941747
2021-10-29;2326;3356;208;2325.0;49944073
2021-10-29;1549;2349;356;-777.0;49945622
2021-10-29;3014;4463;829;1465.0;49948636
2021-10-29;15691;23177;54234;12677.0;49964327
2021-10-29;1578;2393;4277;-14113.0;49965905
2021-10-29;3165;4663;31;1587.0;49969070
2021-10-29;3;5;0;-3162.0;49969073
2021-10-29;190;315;10832;187.0;49969263
2021-10-29;260;461;14092;70.0;49969523
2021-10-29;310;502;12764;50.0;49969833
2021-10-29;36;39;0;-274.0;49969869
2021-10-29;566;771;3274;530.0;49970435
2021-10-29;2311;3264;1241;1745.0;49972746
2021-10-29;382;594;6330;-1929.0;49973128
2021-10-30;300;396;1546;-82.0;49973428
2021-10-30;2117;2921;375;1817.0;49975545
2021-10-30;1;3;0;-2116.0;49975546
2021-10-30;3;2;0;2.0;49975549
2021-10-30;1031;1484;2185;1028.0;49976580
2021-10-30;1681;2559;141;650.0;49978261
2021-10-30;2141;4534;25;460.0;49980402
2021-10-30;108;171;5334;-2033.0;49980510
2021-10-30;198;310;3038;90.0;49980708
2021-10-30;22;31;0;-176.0;49980730
2021-10-30;83;129;4271;61.0;49980813
2021-10-30;1587;2289;661;1504.0;49982400
2021-10-30;1104;1674;161;-483.0;49983504
2021-10-30;10522;16738;23451;9418.0;49994026
2021-10-30;146;235;5714;-10376.0;49994172
2021-10-31;0;0;0;-146.0;49994172
2021-10-31;1294;1958;1745;1294.0;49995466
2021-10-31;0;4;0;-1294.0;49995466
2021-10-31;198;286;21;198.0;49995664
2021-10-31;2;1;0;-196.0;49995666
2021-10-31;227;417;1;225.0;49995893
2021-10-31;28;42;229;-199.0;49995921
2021-10-31;9;11;224;-19.0;49995930
2021-10-31;188;260;90;179.0;49996118
2021-10-31;164;234;39;-24.0;49996282
2021-10-31;7;28;294;-157.0;49996289
2021-10-31;127;171;231;120.0;49996416
2021-10-31;16;35;390;-111.0;49996432
2021-10-31;297;425;92;281.0;49996729
2021-10-31;31;44;134;-266.0;49996760
2021-11-01;117;63;134;86.0;49996877
2021-11-01;43;28;275;-74.0;49996920
2021-11-01;4775;2688;1712;4732.0;50001695
2021-11-01;1326;735;127;-3449.0;50003021
2021-11-01;16;21;283;-1310.0;50003037
2021-11-01;720;406;81;704.0;50003757
2021-11-01;405;230;7;-315.0;50004162
2021-11-01;437;248;221;32.0;50004599
2021-11-01;4;2;1;-433.0;50004603
2021-11-01;65;50;195;61.0;50004668
2021-11-01;848;443;124;783.0;50005516
2021-11-01;23;7;2;-825.0;50005539
2021-11-01;8;0;0;-15.0;50005547
2021-11-01;13;15;203;5.0;50005560
2021-11-01;750;440;59;737.0;50006310
2021-11-02;1410;2093;289;660.0;50007720
2021-11-02;1833;2534;991;423.0;50009553
2021-11-02;217;361;10911;-1616.0;50009770
2021-11-02;184;293;10688;-33.0;50009954
2021-11-02;12;5;0;-172.0;50009966
2021-11-02;45;28;0;33.0;50010011
2021-11-02;2527;3780;670;2482.0;50012538
2021-11-02;12892;18099;43573;10365.0;50025430
2021-11-02;6;1;0;-12886.0;50025436
2021-11-02;135;239;8583;129.0;50025571
2021-11-02;1978;2793;232;1843.0;50027549
2021-11-02;378;612;2663;-1600.0;50027927
2021-11-02;1181;1707;2945;803.0;50029108
2021-11-02;299;514;5574;-882.0;50029407
2021-11-02;2687;3139;27;2388.0;50032094
2021-11-03;2137;3233;230;-550.0;50034231
2021-11-03;42;40;0;-2095.0;50034273
2021-11-03;164;246;11174;122.0;50034437
2021-11-03;4;2;0;-160.0;50034441
2021-11-03;5;3;0;1.0;50034446
2021-11-03;2030;2846;1106;2025.0;50036476
2021-11-03;328;537;7033;-1702.0;50036804
2021-11-03;253;441;14321;-75.0;50037057
2021-11-03;1509;2232;343;1256.0;50038566
2021-11-03;3349;5261;43;1840.0;50041915
2021-11-03;206;400;13187;-3143.0;50042121
2021-11-03;458;657;3305;252.0;50042579
2021-11-03;1407;1952;3607;949.0;50043986
2021-11-03;2795;3934;778;1388.0;50046781
2021-11-03;14687;21784;55127;11892.0;50061468
2021-11-04;1204;1722;292;-13483.0;50062672
2021-11-04;331;446;6307;-873.0;50063003
2021-11-04;1594;2351;1153;1263.0;50064597
2021-11-04;3;1;0;-1591.0;50064600
2021-11-04;2356;2466;29;2353.0;50066956
2021-11-04;4;3;0;-2352.0;50066960
2021-11-04;1213;1652;3758;1209.0;50068173
2021-11-04;260;427;12175;-953.0;50068433
2021-11-04;415;643;3380;155.0;50068848
2021-11-04;11832;15725;49906;11417.0;50080680
2021-11-04;150;222;9493;-11682.0;50080830
2021-11-04;27;25;1;-123.0;50080857
2021-11-04;1761;2358;219;1734.0;50082618
2021-11-04;271;384;12300;-1490.0;50082889
2021-11-04;2243;3025;799;1972.0;50085132
2021-11-05;4;3;0;-2239.0;50085136
2021-11-05;3267;4110;47;3263.0;50088403
2021-11-05;284;432;14740;-2983.0;50088687
2021-11-05;2418;3300;1693;2134.0;50091105
2021-11-05;304;510;17322;-2114.0;50091409
2021-11-05;3055;4339;1111;2751.0;50094464
2021-11-05;1650;2367;411;-1405.0;50096114
2021-11-05;2278;3235;304;628.0;50098392
2021-11-05;563;814;4600;-1715.0;50098955
2021-11-05;175;300;12125;-388.0;50099130
2021-11-05;408;565;8733;233.0;50099538
2021-11-05;1741;2380;5419;1333.0;50101279
2021-11-05;16196;22403;66506;14455.0;50117475
2021-11-05;45;41;1;-16151.0;50117520
2021-11-05;4;7;0;-41.0;50117524
2021-11-06;1;3;0;-3.0;50117525
2021-11-06;38;19;0;37.0;50117563
2021-11-06;131;182;7826;93.0;50117694
2021-11-06;1135;1510;3170;1004.0;50118829
2021-11-06;2402;4152;25;1267.0;50121231
2021-11-06;2210;3047;607;-192.0;50123441
2021-11-06;117;207;5863;-2093.0;50123558
2021-11-06;236;292;4345;119.0;50123794
2021-11-06;1617;2309;1063;1381.0;50125411
2021-11-06;10910;16386;30492;9293.0;50136321
2021-11-06;261;398;2335;-10649.0;50136582
2021-11-06;3;2;0;-258.0;50136585
2021-11-06;1127;1670;241;1124.0;50137712
2021-11-06;80;129;4818;-1047.0;50137792
2021-11-06;1552;2466;199;1472.0;50139344
2021-11-07;131;227;40;-1421.0;50139475
2021-11-07;216;363;4;85.0;50139691
2021-11-07;185;346;114;-31.0;50139876
2021-11-07;48;69;235;-137.0;50139924
2021-11-07;20;29;567;-28.0;50139944
2021-11-07;19;23;400;-1.0;50139963
2021-11-07;1228;2035;2478;1209.0;50141191
2021-11-07;113;195;314;-1115.0;50141304
2021-11-07;190;292;36;77.0;50141494
2021-11-07;3;1;0;-187.0;50141497
2021-11-07;259;425;101;256.0;50141756
2021-11-07;0;0;0;-259.0;50141756
2021-11-07;7;17;310;7.0;50141763
2021-11-07;3;4;0;-4.0;50141766
2021-11-07;34;44;357;31.0;50141800
2021-11-08;1522;2473;323;1488.0;50143322
2021-11-08;1307;1884;482;-215.0;50144629
2021-11-08;10287;15578;59509;8980.0;50154916
2021-11-08;137;198;9767;-10150.0;50155053
2021-11-08;15;23;0;-122.0;50155068
2021-11-08;1080;1534;4337;1065.0;50156148
2021-11-08;9;1;0;-1071.0;50156157
2021-11-08;2378;3212;1179;2369.0;50158535
2021-11-08;0;3;0;-2378.0;50158535
2021-11-08;295;446;8849;295.0;50158830
2021-11-08;1610;2293;1758;1315.0;50160440
2021-11-08;1116;2251;16;-494.0;50161556
2021-11-08;174;302;10833;-942.0;50161730
2021-11-08;385;601;4034;211.0;50162115
2021-11-08;259;357;17931;-126.0;50162374
2021-11-09;1695;2294;2165;1436.0;50164069
2021-11-09;1194;1741;545;-501.0;50165263
2021-11-09;1306;2539;18;112.0;50166569
2021-11-09;492;671;5419;-814.0;50167061
2021-11-09;174;258;12944;-318.0;50167235
2021-11-09;396;564;10727;222.0;50167631
2021-11-09;1293;1713;5790;897.0;50168924
2021-11-09;11007;16222;75122;9714.0;50179931
2021-11-09;21;30;1;-10986.0;50179952
2021-11-09;2315;3192;1504;2294.0;50182267
2021-11-09;4;4;0;-2311.0;50182271
2021-11-09;1;3;0;-3.0;50182272
2021-11-09;283;438;20107;282.0;50182555
2021-11-09;1521;2325;326;1238.0;50184076
2021-11-09;312;450;15576;-1209.0;50184388
2021-11-10;15643;21828;87190;15331.0;50200031
2021-11-10;2186;2978;2903;-13457.0;50202217
2021-11-10;39;57;1;-2147.0;50202256
2021-11-10;2985;3910;1735;2946.0;50205241
2021-11-10;342;440;24643;-2643.0;50205583
2021-11-10;8;4;0;-334.0;50205591
2021-11-10;1526;1904;7097;1518.0;50207117
2021-11-10;1505;2130;632;-21.0;50208622
2021-11-10;439;555;13672;-1066.0;50209061
2021-11-10;5;7;0;-434.0;50209066
2021-11-10;3650;5517;47;3645.0;50212716
2021-11-10;1989;2983;479;-1661.0;50214705
2021-11-10;509;679;6257;-1480.0;50215214
2021-11-10;287;445;15483;-222.0;50215501
2021-11-10;173;219;14241;-114.0;50215674
2021-11-11;1;2;4;-172.0;50215675
2021-11-11;300;475;118;299.0;50215975
2021-11-11;376;523;128;76.0;50216351
2021-11-11;18;12;0;-358.0;50216369
2021-11-11;20;49;879;2.0;50216389
2021-11-11;533;769;282;513.0;50216922
2021-11-11;372;492;362;-161.0;50217294
2021-11-11;2422;3170;6390;2050.0;50219716
2021-11-11;26;28;803;-2396.0;50219742
2021-11-11;41;57;1450;15.0;50219783
2021-11-11;362;326;13;321.0;50220145
2021-11-11;241;281;778;-121.0;50220386
2021-11-11;64;88;591;-177.0;50220450
2021-11-11;56;66;982;-8.0;50220506
2021-11-11;12;2;0;-44.0;50220518
2021-11-12;1492;2165;620;1480.0;50222010
2021-11-12;6;2;1;-1486.0;50222016
2021-11-12;431;580;14668;425.0;50222447
2021-11-12;3055;4226;1589;2624.0;50225502
2021-11-12;281;516;24129;-2774.0;50225783
2021-11-12;14616;20852;87501;14335.0;50240399
2021-11-12;535;712;6789;-14081.0;50240934
2021-11-12;277;396;14946;-258.0;50241211
2021-11-12;2314;3131;2905;2037.0;50243525
2021-11-12;207;295;13582;-2107.0;50243732
2021-11-12;1966;3059;461;1759.0;50245698
2021-11-12;3;1;3;-1963.0;50245701
2021-11-12;1626;2219;7774;1623.0;50247327
2021-11-12;2395;3521;34;769.0;50249722
2021-11-12;28;29;0;-2367.0;50249750
2021-11-13;95;169;5797;67.0;50249845
2021-11-13;1003;1409;329;908.0;50250848
2021-11-13;944;1310;4085;-59.0;50251792
2021-11-13;10213;14399;38400;9269.0;50262005
2021-11-13;0;0;0;-10213.0;50262005
2021-11-13;1506;2053;1506;1506.0;50263511
2021-11-13;135;192;10154;-1371.0;50263646
2021-11-13;1925;2620;828;1790.0;50265571
2021-11-13;3;0;0;-1922.0;50265574
2021-11-13;163;241;6478;160.0;50265737
2021-11-13;75;119;5650;-88.0;50265812
2021-11-13;1492;2264;282;1417.0;50267304
2021-11-13;2555;3620;45;1063.0;50269859
2021-11-13;293;377;3245;-2262.0;50270152
2021-11-13;24;25;1;-269.0;50270176
2021-11-14;150;233;33;126.0;50270326
2021-11-14;14;22;497;-136.0;50270340
2021-11-14;285;389;126;271.0;50270625
2021-11-14;108;205;47;-177.0;50270733
2021-11-14;0;0;0;-108.0;50270733
2021-11-14;26;46;346;26.0;50270759
2021-11-14;25;30;626;-1.0;50270784
2021-11-14;9;14;438;-16.0;50270793
2021-11-14;15;26;758;6.0;50270808
2021-11-14;1171;1684;3526;1156.0;50271979
2021-11-14;7;3;0;-1164.0;50271986
2021-11-14;95;153;481;88.0;50272081
2021-11-14;171;281;167;76.0;50272252
2021-11-14;0;2;0;-171.0;50272252
2021-11-14;266;280;7;266.0;50272518
2021-11-15;346;436;14320;80.0;50272864
2021-11-15;10357;13895;76021;10011.0;50283221
2021-11-15;1140;1452;5722;-9217.0;50284361
2021-11-15;14;19;1;-1126.0;50284375
2021-11-15;1185;1621;570;1171.0;50285560
2021-11-15;265;357;22364;-920.0;50285825
2021-11-15;7;8;0;-258.0;50285832
2021-11-15;1174;1763;32;1167.0;50287006
2021-11-15;2265;3087;1450;1091.0;50289271
2021-11-15;1565;2138;433;-700.0;50290836
2021-11-15;422;499;5872;-1143.0;50291258
2021-11-15;1656;2047;2155;1234.0;50292914
2021-11-15;122;182;11469;-1534.0;50293036
2021-11-15;185;285;11633;63.0;50293221
2021-11-15;11;1;0;-174.0;50293232
2021-11-16;2501;2833;1760;2490.0;50295733
2021-11-16;5;1;0;-2496.0;50295738
2021-11-16;313;405;26111;308.0;50296051
2021-11-16;176;243;14825;-137.0;50296227
2021-11-16;17;21;2;-159.0;50296244
2021-11-16;506;551;7673;489.0;50296750
2021-11-16;1364;1440;7203;858.0;50298114
2021-11-16;11750;13784;94092;10386.0;50309864
2021-11-16;1944;2092;2482;-9806.0;50311808
2021-11-16;1599;2005;461;-345.0;50313407
2021-11-16;466;501;16920;-1133.0;50313873
2021-11-16;1264;1729;26;798.0;50315137
2021-11-16;1299;1568;662;35.0;50316436
2021-11-16;294;394;15967;-1005.0;50316730
2021-11-16;2;1;0;-292.0;50316732
2021-11-17;182;229;13987;180.0;50316914
2021-11-17;2221;2334;2841;2039.0;50319135
2021-11-17;7;4;3;-2214.0;50319142
2021-11-17;2780;3250;1867;2773.0;50321922
2021-11-17;321;388;26093;-2459.0;50322243
2021-11-17;1473;1679;7919;1152.0;50323716
2021-11-17;260;327;14591;-1213.0;50323976
2021-11-17;1976;2468;512;1716.0;50325952
2021-11-17;544;593;7864;-1432.0;50326496
2021-11-17;466;505;16941;-78.0;50326962
2021-11-17;39;56;1;-427.0;50327001
2021-11-17;15157;18185;93405;15118.0;50342158
2021-11-17;1333;1736;710;-13824.0;50343491
2021-11-17;3549;4615;76;2216.0;50347040
2021-11-17;6;1;0;-3543.0;50347046
2021-11-18;1338;1506;8148;1332.0;50348384
2021-11-18;20;21;0;-1318.0;50348404
2021-11-18;397;484;15636;377.0;50348801
2021-11-18;11580;14284;89062;11183.0;50360381
2021-11-18;2448;2962;1974;-9132.0;50362829
2021-11-18;324;379;23105;-2124.0;50363153
2021-11-18;3;3;0;-321.0;50363156
2021-11-18;1376;1960;36;1373.0;50364532
2021-11-18;540;544;8134;-836.0;50365072
2021-11-18;1874;2098;2815;1334.0;50366946
2021-11-18;1198;1532;793;-676.0;50368144
2021-11-18;1597;2146;561;399.0;50369741
2021-11-18;188;218;13087;-1409.0;50369929
2021-11-18;2;3;2;-186.0;50369931
2021-11-18;275;428;14771;273.0;50370206
2021-11-19;361;402;16740;86.0;50370567
2021-11-19;1949;2069;12415;1588.0;50372516
2021-11-19;501;577;20207;-1448.0;50373017
2021-11-19;31;43;0;-470.0;50373048
2021-11-19;2167;2789;715;2136.0;50375215
2021-11-19;4;4;1;-2163.0;50375219
2021-11-19;16695;19746;113410;16691.0;50391914
2021-11-19;3509;3875;2652;-13186.0;50395423
2021-11-19;2555;3616;57;-954.0;50397978
2021-11-19;8;1;1;-2547.0;50397986
2021-11-19;674;703;10985;666.0;50398660
2021-11-19;1611;1928;916;937.0;50400271
2021-11-19;369;452;29139;-1242.0;50400640
2021-11-19;2738;2999;4213;2369.0;50403378
2021-11-19;218;288;15369;-2520.0;50403596
2021-11-20;330;347;5422;112.0;50403926
2021-11-20;1275;1338;7461;945.0;50405201
2021-11-20;217;239;8387;-1058.0;50405418
2021-11-20;2467;2767;1236;2250.0;50407885
2021-11-20;2;0;0;-2465.0;50407887
2021-11-20;1160;1488;450;1158.0;50409047
2021-11-20;12905;14855;48272;11745.0;50421952
2021-11-20;4;6;0;-12901.0;50421956
2021-11-20;95;116;5433;91.0;50422051
2021-11-20;1925;1948;2485;1830.0;50423976
2021-11-20;197;212;10948;-1728.0;50424173
2021-11-20;158;157;5948;-39.0;50424331
2021-11-20;1731;2295;433;1573.0;50426062
2021-11-20;3313;3905;68;1582.0;50429375
2021-11-20;31;37;1;-3282.0;50429406
2021-11-21;36;44;587;5.0;50429442
2021-11-21;220;298;307;184.0;50429662
2021-11-21;23;27;891;-197.0;50429685
2021-11-21;18;20;495;-5.0;50429703
2021-11-21;150;228;82;132.0;50429853
2021-11-21;273;386;191;123.0;50430126
2021-11-21;19;28;515;-254.0;50430145
2021-11-21;1359;1829;4768;1340.0;50431504
2021-11-21;4;3;0;-1355.0;50431508
2021-11-21;290;301;12;286.0;50431798
2021-11-21;1;0;0;-289.0;50431799
2021-11-21;123;170;799;122.0;50431922
2021-11-21;31;40;820;-92.0;50431953
2021-11-21;171;283;69;140.0;50432124
2021-11-21;0;1;0;-171.0;50432124
2021-11-22;193;229;10592;193.0;50432317
2021-11-22;1340;1109;61;1147.0;50433657
2021-11-22;405;323;9031;-935.0;50434062
2021-11-22;1921;1440;3456;1516.0;50435983
2021-11-22;1253;907;9337;-668.0;50437236
2021-11-22;169;177;10701;-1084.0;50437405
2021-11-22;1291;1193;836;1122.0;50438696
2021-11-22;2632;2107;2195;1341.0;50441328
2021-11-22;1701;1392;691;-931.0;50443029
2021-11-22;263;262;22231;-1438.0;50443292
2021-11-22;17;26;2;-246.0;50443309
2021-11-22;412;327;16381;395.0;50443721
2021-11-22;11609;9500;85517;11197.0;50455330
2021-11-22;5;5;3;-11604.0;50455335
2021-11-22;7;3;0;2.0;50455342
2021-11-23;1293;1353;996;1286.0;50456635
2021-11-23;456;422;19761;-837.0;50457091
2021-11-23;567;509;12011;111.0;50457658
2021-11-23;340;343;14909;-227.0;50457998
2021-11-23;2143;1730;4484;1803.0;50460141
2021-11-23;337;334;26468;-1806.0;50460478
2021-11-23;1482;1406;54;1145.0;50461960
2021-11-23;5;6;2;-1477.0;50461965
2021-11-23;29;19;1;24.0;50461994
2021-11-23;218;214;13697;189.0;50462212
2021-11-23;1847;1882;771;1629.0;50464059
2021-11-23;4;4;1;-1843.0;50464063
2021-11-23;1492;1301;12441;1488.0;50465555
2021-11-23;12941;12070;108191;11449.0;50478496
2021-11-23;2728;2547;2595;-10213.0;50481224
2021-11-24;563;565;12243;-2165.0;50481787
2021-11-24;0;5;1;-563.0;50481787
2021-11-24;195;238;12521;195.0;50481982
2021-11-24;1923;2198;818;1728.0;50483905
2021-11-24;285;323;13153;-1638.0;50484190
2021-11-24;356;380;25517;71.0;50484546
2021-11-24;2225;2220;5203;1869.0;50486771
2021-11-24;1551;1617;14054;-674.0;50488322
2021-11-24;462;455;18836;-1089.0;50488784
2021-11-24;6;0;0;-456.0;50488790
2021-11-24;4100;4296;92;4094.0;50492890
2021-11-24;15845;16976;106281;11745.0;50508735
2021-11-24;32;43;3;-15813.0;50508767
2021-11-24;1378;1638;1058;1346.0;50510145
2021-11-24;2769;2998;2782;1391.0;50512914
2021-11-25;353;402;25611;-2416.0;50513267
2021-11-25;4;2;1;-349.0;50513271
2021-11-25;1629;1370;18195;1625.0;50514900
2021-11-25;444;413;20516;-1185.0;50515344
2021-11-25;1604;1528;64;1160.0;50516948
2021-11-25;2070;1846;8096;466.0;50519018
2021-11-25;1627;1797;1306;-443.0;50520645
2021-11-25;12830;12326;121970;11203.0;50533475
2021-11-25;6;1;0;-12824.0;50533481
2021-11-25;338;363;14132;332.0;50533819
2021-11-25;203;223;12378;-135.0;50534022
2021-11-25;565;494;15174;362.0;50534587
2021-11-25;1330;1357;1717;765.0;50535917
2021-11-25;23;28;4;-1307.0;50535940
2021-11-25;2634;2502;4776;2611.0;50538574
2021-11-26;4;8;0;-2630.0;50538578
2021-11-26;705;693;23632;701.0;50539283
2021-11-26;365;449;33774;-340.0;50539648
2021-11-26;1586;1896;3203;1221.0;50541234
2021-11-26;2769;3336;175;1183.0;50544003
2021-11-26;16811;18665;183792;14042.0;50560814
2021-11-26;515;569;29670;-16296.0;50561329
2021-11-26;5;9;4;-510.0;50561334
2021-11-26;2086;2046;32912;2081.0;50563420
2021-11-26;31;41;0;-2055.0;50563451
2021-11-26;3373;3627;9689;3342.0;50566824
2021-11-26;2070;2551;2783;-1303.0;50568894
2021-11-26;2729;2786;17239;659.0;50571623
2021-11-26;346;391;15869;-2383.0;50571969
2021-11-26;227;263;14842;-119.0;50572196
2021-11-27;1504;2025;3611;1277.0;50573700
2021-11-27;38;41;3;-1466.0;50573738
2021-11-27;1263;1442;26186;1225.0;50575001
2021-11-27;410;344;13956;-853.0;50575411
2021-11-27;99;126;5392;-311.0;50575510
2021-11-27;12004;14480;109750;11905.0;50587514
2021-11-27;1023;1366;2970;-10981.0;50588537
2021-11-27;3185;3798;214;2162.0;50591722
2021-11-27;130;153;5856;-3055.0;50591852
2021-11-27;2105;2647;8765;1975.0;50593957
2021-11-27;188;225;13273;-1917.0;50594145
2021-11-27;1822;2045;16207;1634.0;50595967
2021-11-27;3;1;0;-1819.0;50595970
2021-11-27;232;262;13316;229.0;50596202
2021-11-27;2;5;1;-230.0;50596204
2021-11-28;8;5;2;6.0;50596212
2021-11-28;186;245;1633;178.0;50596398
2021-11-28;12;20;610;-174.0;50596410
2021-11-28;31;44;2121;19.0;50596441
2021-11-28;253;315;1798;222.0;50596694
2021-11-28;288;348;6965;35.0;50596982
2021-11-28;354;467;4306;66.0;50597336
2021-11-28;26;40;1700;-328.0;50597362
2021-11-28;3;4;0;-23.0;50597365
2021-11-28;39;57;3279;36.0;50597404
2021-11-28;1;0;0;-38.0;50597405
2021-11-28;195;216;7789;194.0;50597600
2021-11-28;1762;2085;30944;1567.0;50599362
2021-11-28;353;297;72;-1409.0;50599715
2021-11-28;13;27;669;-340.0;50599728
2021-11-29;5;2;0;-8.0;50599733
2021-11-29;13;22;4;8.0;50599746
2021-11-29;1601;1837;20376;1588.0;50601347
2021-11-29;9696;11585;169178;8095.0;50611043
2021-11-29;1282;1269;179;-8414.0;50612325
2021-11-29;1231;1605;4238;-51.0;50613556
2021-11-29;1052;1359;4657;-179.0;50614608
2021-11-29;146;203;9841;-906.0;50614754
2021-11-29;202;212;10568;56.0;50614956
2021-11-29;1192;1404;31289;990.0;50616148
2021-11-29;396;461;22511;-796.0;50616544
2021-11-29;244;330;25988;-152.0;50616788
2021-11-29;345;378;26838;101.0;50617133
2021-11-29;1985;2497;12685;1640.0;50619118
2021-11-29;2;6;4;-1983.0;50619120
2021-11-30;2007;2067;27052;2005.0;50621127
2021-11-30;301;328;14916;-1706.0;50621428
2021-11-30;21;27;3;-280.0;50621449
2021-11-30;2649;2763;16875;2628.0;50624098
2021-11-30;1;2;2;-2648.0;50624099
2021-11-30;4;5;5;3.0;50624103
2021-11-30;476;504;34561;472.0;50624579
2021-11-30;1488;1472;200;1012.0;50626067
2021-11-30;1321;1466;5954;-167.0;50627388
2021-11-30;370;370;33767;-951.0;50627758
2021-11-30;569;567;31574;199.0;50628327
2021-11-30;1530;1603;42950;961.0;50629857
2021-11-30;12511;13218;226794;10981.0;50642368
2021-11-30;1531;1792;5641;-10980.0;50643899
2021-11-30;243;252;13294;-1288.0;50644142
2021-12-01;284;355;29338;41.0;50644426
2021-12-01;276;310;12072;-8.0;50644702
2021-12-01;24;1;2;-252.0;50644726
2021-12-01;429;499;32971;405.0;50645155
2021-12-01;2086;2147;26945;1657.0;50647241
2021-12-01;2562;2787;16243;476.0;50649803
2021-12-01;8;1;4;-2554.0;50649811
2021-12-01;167;200;10780;159.0;50649978
2021-12-01;1469;1778;53217;1302.0;50651447
2021-12-01;1272;1559;5955;-197.0;50652719
2021-12-01;13810;15478;231971;12538.0;50666529
2021-12-01;1570;1846;5952;-12240.0;50668099
2021-12-01;3082;3336;326;1512.0;50671181
2021-12-01;65;42;4;-3017.0;50671246
2021-12-01;516;617;38162;451.0;50671762
2021-12-02;1413;1387;57649;897.0;50673175
2021-12-02;453;399;37059;-960.0;50673628
2021-12-02;311;340;13737;-142.0;50673939
2021-12-02;1850;1596;32748;1539.0;50675789
2021-12-02;28;31;6;-1822.0;50675817
2021-12-02;1376;1054;279;1348.0;50677193
2021-12-02;544;512;41840;-832.0;50677737
2021-12-02;11163;10431;262114;10619.0;50688900
2021-12-02;329;336;32134;-10834.0;50689229
2021-12-02;2184;2024;20247;1855.0;50691413
2021-12-02;5;7;5;-2179.0;50691418
2021-12-02;1385;1434;7287;1380.0;50692803
2021-12-02;190;237;11865;-1195.0;50692993
2021-12-02;1086;1069;7255;896.0;50694079
2021-12-02;9;5;3;-1077.0;50694088
2021-12-03;1427;2148;8404;1418.0;50695515
2021-12-03;581;698;44150;-846.0;50696096
2021-12-03;12841;16993;294441;12260.0;50708937
2021-12-03;2;7;9;-12839.0;50708939
2021-12-03;1192;1753;7878;1190.0;50710131
2021-12-03;438;565;41037;-754.0;50710569
2021-12-03;11;7;1;-427.0;50710580
2021-12-03;31;37;10;20.0;50710611
2021-12-03;2075;2712;38179;2044.0;50712686
2021-12-03;321;418;35113;-1754.0;50713007
2021-12-03;197;275;12269;-124.0;50713204
2021-12-03;2662;3417;22821;2465.0;50715866
2021-12-03;309;364;14142;-2353.0;50716175
2021-12-03;1924;2392;428;1615.0;50718099
2021-12-03;1671;2200;70000;-253.0;50719770
2021-12-04;228;264;17506;-1443.0;50719998
2021-12-04;1467;1959;27889;1239.0;50721465
2021-12-04;0;0;3;-1467.0;50721465
2021-12-04;1726;2470;16260;1726.0;50723191
2021-12-04;321;390;22405;-1405.0;50723512
2021-12-04;110;113;4781;-211.0;50723622
2021-12-04;9325;13071;173122;9215.0;50732947
2021-12-04;1123;1824;8511;-8202.0;50734070
2021-12-04;825;1294;5946;-298.0;50734895
2021-12-04;7;1;0;-818.0;50734902
2021-12-04;38;31;6;31.0;50734940
2021-12-04;199;188;14160;161.0;50735139
2021-12-04;124;153;5404;-75.0;50735263
2021-12-04;2092;2915;546;1968.0;50737355
2021-12-04;1065;1469;49705;-1027.0;50738420
2021-12-05;12;17;737;-1053.0;50738432
2021-12-05;61;66;5224;49.0;50738493
2021-12-05;49;54;3203;-12.0;50738542
2021-12-05;409;507;7356;360.0;50738951
2021-12-05;316;403;11329;-93.0;50739267
2021-12-05;1;1;3;-315.0;50739268
2021-12-05;2122;2442;51108;2121.0;50741390
2021-12-05;279;347;3671;-1843.0;50741669
2021-12-05;216;265;2755;-63.0;50741885
2021-12-05;2;0;0;-214.0;50741887
2021-12-05;448;393;220;446.0;50742335
2021-12-05;23;35;878;-425.0;50742358
2021-12-05;34;49;2136;11.0;50742392
2021-12-05;260;301;13593;226.0;50742652
2021-12-05;12;4;3;-248.0;50742664
2021-12-06;2730;2175;35693;2718.0;50745394
2021-12-06;19;5;5;-2711.0;50745413
2021-12-06;15744;12917;249575;15725.0;50761157
2021-12-06;2126;1799;8749;-13618.0;50763283
2021-12-06;1801;1616;56168;-325.0;50765084
2021-12-06;1808;1392;8702;7.0;50766892
2021-12-06;53;7;1;-1755.0;50766945
2021-12-06;603;524;37316;550.0;50767548
2021-12-06;311;355;26265;-292.0;50767859
2021-12-06;448;465;35228;137.0;50768307
2021-12-06;3643;2909;22959;3195.0;50771950
2021-12-06;1685;1163;343;-1958.0;50773635
2021-12-06;173;227;8706;-1512.0;50773808
2021-12-06;114;23;0;-59.0;50773922
2021-12-06;230;257;9440;116.0;50774152
2021-12-07;29;31;6;-201.0;50774181
2021-12-07;1487;1841;69360;1458.0;50775668
2021-12-07;1979;2430;44021;492.0;50777647
2021-12-07;11848;14401;323030;9869.0;50789495
2021-12-07;1;6;6;-11847.0;50789496
2021-12-07;5;8;1;4.0;50789501
2021-12-07;327;367;14631;322.0;50789828
2021-12-07;584;719;48516;257.0;50790412
2021-12-07;212;266;12691;-372.0;50790624
2021-12-07;2461;3011;28485;2249.0;50793085
2021-12-07;1326;1328;419;-1135.0;50794411
2021-12-07;1211;1533;10257;-115.0;50795622
2021-12-07;458;571;47476;-753.0;50796080
2021-12-07;1406;1868;10469;948.0;50797486
2021-12-07;362;422;36692;-1044.0;50797848
2021-12-08;501;678;42013;139.0;50798349
2021-12-08;1052;1631;9687;551.0;50799401
2021-12-08;1792;2513;42736;740.0;50801193
2021-12-08;56;29;3;-1736.0;50801249
2021-12-08;323;424;30462;267.0;50801572
2021-12-08;408;555;41102;85.0;50801980
2021-12-08;15;9;0;-393.0;50801995
2021-12-08;2964;3613;596;2949.0;50804959
2021-12-08;212;265;10427;-2752.0;50805171
2021-12-08;1417;1955;65010;1205.0;50806588
2021-12-08;1285;2144;10018;-132.0;50807873
2021-12-08;1;8;5;-1284.0;50807874
2021-12-08;266;355;11635;265.0;50808140
2021-12-08;2178;3157;26474;1912.0;50810318
2021-12-08;12470;17336;290168;10292.0;50822788
2021-12-09;1496;1814;73770;-10974.0;50824284
2021-12-09;11972;14437;331121;10476.0;50836256
2021-12-09;8;9;7;-11964.0;50836264
2021-12-09;1215;1552;11530;1207.0;50837479
2021-12-09;26;22;2;-1189.0;50837505
2021-12-09;1403;1964;12444;1377.0;50838908
2021-12-09;2386;3051;32216;983.0;50841294
2021-12-09;1480;1412;567;-906.0;50842774
2021-12-09;571;652;47856;-909.0;50843345
2021-12-09;448;558;45124;-123.0;50843793
2021-12-09;251;265;11587;-197.0;50844044
2021-12-09;7;6;0;-244.0;50844051
2021-12-09;1952;2312;49028;1945.0;50846003
2021-12-09;360;381;13578;-1592.0;50846363
2021-12-09;369;439;33412;9.0;50846732
2021-12-10;2286;3148;56908;1917.0;50849018
2021-12-10;14;7;1;-2272.0;50849032
2021-12-10;258;285;11805;244.0;50849290
2021-12-10;355;491;35075;97.0;50849645
2021-12-10;1343;1909;12632;988.0;50850988
2021-12-10;514;647;47806;-829.0;50851502
2021-12-10;14135;19029;366242;13621.0;50865637
2021-12-10;1621;2491;14452;-12514.0;50867258
2021-12-10;7;8;4;-1614.0;50867265
2021-12-10;2122;2536;851;2115.0;50869387
2021-12-10;55;35;7;-2067.0;50869442
2021-12-10;1816;2413;87709;1761.0;50871258
2021-12-10;576;766;49373;-1240.0;50871834
2021-12-10;2792;3890;35922;2216.0;50874626
2021-12-10;376;403;13697;-2416.0;50875002
2021-12-11;209;261;14508;-167.0;50875211
2021-12-11;958;1532;9646;749.0;50876169
2021-12-11;40;42;4;-918.0;50876209
2021-12-11;1205;2100;15059;1165.0;50877414
2021-12-11;128;142;5027;-1077.0;50877542
2021-12-11;10322;15449;227400;10194.0;50887864
2021-12-11;5;10;7;-10317.0;50887869
2021-12-11;1603;2400;42727;1598.0;50889472
2021-12-11;1975;2944;25527;372.0;50891447
2021-12-11;189;203;5976;-1786.0;50891636
2021-12-11;4;7;0;-185.0;50891640
2021-12-11;234;302;20218;230.0;50891874
2021-12-11;388;477;25723;154.0;50892262
2021-12-11;1188;1739;61794;800.0;50893450
2021-12-11;2196;3290;1184;1008.0;50895646
2021-12-12;431;533;17574;-1765.0;50896077
2021-12-12;331;381;20028;-100.0;50896408
2021-12-12;608;437;388;277.0;50897016
2021-12-12;565;734;11712;-43.0;50897581
2021-12-12;70;67;4414;-495.0;50897651
2021-12-12;106;104;6874;36.0;50897757
2021-12-12;32;32;1077;-74.0;50897789
2021-12-12;35;64;2958;3.0;50897824
2021-12-12;312;378;4472;277.0;50898136
2021-12-12;357;451;5810;45.0;50898493
2021-12-12;5;0;0;-352.0;50898498
2021-12-12;2911;3238;76571;2906.0;50901409
2021-12-12;2;2;3;-2909.0;50901411
2021-12-12;7;6;2;5.0;50901418
2021-12-12;50;49;1259;43.0;50901468
2021-12-13;500;653;40603;450.0;50901968
2021-12-13;11;5;1;-489.0;50901979
2021-12-13;1315;2113;13678;1304.0;50903294
2021-12-13;407;556;37228;-908.0;50903701
2021-12-13;300;417;25559;-107.0;50904001
2021-12-13;294;300;9817;-6.0;50904295
2021-12-13;26;22;8;-268.0;50904321
2021-12-13;1767;2501;50424;1741.0;50906088
2021-12-13;5;12;13;-1762.0;50906093
2021-12-13;1246;1459;639;1241.0;50907339
2021-12-13;10707;15057;303150;9461.0;50918046
2021-12-13;2198;3185;34642;-8509.0;50920244
2021-12-13;1136;1708;12750;-1062.0;50921380
2021-12-13;208;248;8816;-928.0;50921588
2021-12-13;1294;1878;68972;1086.0;50922882
2021-12-14;402;444;15473;-892.0;50923284
2021-12-14;1575;1637;810;1173.0;50924859
2021-12-14;2363;2992;61282;788.0;50927222
2021-12-14;671;849;53754;-1692.0;50927893
2021-12-14;1676;2266;86739;1005.0;50929569
2021-12-14;2951;3834;42861;1275.0;50932520
2021-12-14;1654;2397;16138;-1297.0;50934174
2021-12-14;14001;17982;393244;12347.0;50948175
2021-12-14;4;14;6;-13997.0;50948179
2021-12-14;41;33;5;37.0;50948220
2021-12-14;270;322;12905;229.0;50948490
2021-12-14;447;589;36892;177.0;50948937
2021-12-14;583;682;51061;136.0;50949520
2021-12-14;1350;1915;15314;767.0;50950870
2021-12-14;14;8;4;-1336.0;50950884
2021-12-15;3005;3877;1214;2991.0;50953889
2021-12-15;237;305;10508;-2768.0;50954126
2021-12-15;383;482;29699;146.0;50954509
2021-12-15;1248;1929;14473;865.0;50955757
2021-12-15;2438;3690;39185;1190.0;50958195
2021-12-15;1579;2069;80157;-859.0;50959774
2021-12-15;63;14;2;-1516.0;50959837
2021-12-15;340;402;12614;277.0;50960177
2021-12-15;1629;2513;16333;1289.0;50961806
2021-12-15;13;11;3;-1616.0;50961819
2021-12-15;122;63;9;109.0;50961941
2021-12-15;1984;2907;57991;1862.0;50963925
2021-12-15;480;674;42128;-1504.0;50964405
2021-12-15;557;778;45690;77.0;50964962
2021-12-15;14078;19714;350006;13521.0;50979040
2021-12-16;304;339;11264;-13774.0;50979344
2021-12-16;2833;3590;45906;2529.0;50982177
2021-12-16;85;37;4;-2748.0;50982262
2021-12-16;1626;2341;19773;1541.0;50983888
2021-12-16;1306;1796;16981;-320.0;50985194
2021-12-16;464;513;31932;-842.0;50985658
2021-12-16;2248;2879;64972;1784.0;50987906
2021-12-16;7;10;7;-2241.0;50987913
2021-12-16;14074;17585;390707;14067.0;51001987
2021-12-16;708;851;50947;-13366.0;51002695
2021-12-16;580;680;44380;-128.0;51003275
2021-12-16;416;455;14149;-164.0;51003691
2021-12-16;1659;1748;1059;1243.0;51005350
2021-12-16;71;12;1;-1588.0;51005421
2021-12-16;1767;2334;89332;1696.0;51007188
2021-12-17;410;553;30362;-1357.0;51007598
2021-12-17;489;482;13182;79.0;51008087
2021-12-17;2514;3570;72445;2025.0;51010601
2021-12-17;3096;4261;49701;582.0;51013697
2021-12-17;1470;2122;18191;-1626.0;51015167
2021-12-17;2012;2884;101148;542.0;51017179
2021-12-17;2341;3053;1814;329.0;51019520
2021-12-17;8;15;8;-2333.0;51019528
2021-12-17;16075;21813;414361;16067.0;51035603
2021-12-17;107;10;2;-15968.0;51035710
2021-12-17;143;38;7;36.0;51035853
2021-12-17;1862;2805;24400;1719.0;51037715
2021-12-17;288;343;10589;-1574.0;51038003
2021-12-17;585;699;42957;297.0;51038588
2021-12-17;750;978;49555;165.0;51039338
2021-12-18;146;137;4184;-604.0;51039484
2021-12-18;256;56;10;110.0;51039740
2021-12-18;335;348;16749;79.0;51040075
2021-12-18;1426;1676;66333;1091.0;51041501
2021-12-18;225;253;11481;-1201.0;51041726
2021-12-18;1156;1521;13309;931.0;51042882
2021-12-18;1879;2274;50736;723.0;51044761
2021-12-18;2405;2833;32924;526.0;51047166
2021-12-18;1420;2215;24354;-985.0;51048586
2021-12-18;12743;15401;251541;11323.0;51061329
2021-12-18;435;490;23885;-12308.0;51061764
2021-12-18;4;8;4;-431.0;51061768
2021-12-18;217;192;5278;213.0;51061985
2021-12-18;227;17;1;10.0;51062212
2021-12-18;2612;3381;2293;2385.0;51064824
2021-12-19;450;430;22489;-2162.0;51065274
2021-12-19;782;540;1001;332.0;51066056
2021-12-19;393;445;6165;-389.0;51066449
2021-12-19;547;614;10560;154.0;51066996
2021-12-19;97;80;3774;-450.0;51067093
2021-12-19;922;865;16331;825.0;51068015
2021-12-19;163;30;3;-759.0;51068178
2021-12-19;124;138;6751;-39.0;51068302
2021-12-19;47;55;1165;-77.0;51068349
2021-12-19;4457;3955;93026;4410.0;51072806
2021-12-19;2;4;5;-4455.0;51072808
2021-12-19;41;34;964;39.0;51072849
2021-12-19;179;11;0;138.0;51073028
2021-12-19;645;640;21333;466.0;51073673
2021-12-19;65;69;2485;-580.0;51073738
2021-12-20;378;409;16166;313.0;51074116
2021-12-20;7;18;10;-371.0;51074123
2021-12-20;360;35;4;353.0;51074483
2021-12-20;1971;2524;33562;1611.0;51076454
2021-12-20;2985;3426;43567;1014.0;51079439
2021-12-20;3017;2525;3478;32.0;51082456
2021-12-20;630;677;31234;-2387.0;51083086
2021-12-20;16399;17244;314006;15769.0;51099485
2021-12-20;510;502;23761;-15889.0;51099995
2021-12-20;2366;2663;60077;1856.0;51102361
2021-12-20;209;233;5779;-2157.0;51102570
2021-12-20;1416;1837;17428;1207.0;51103986
2021-12-20;303;289;7138;-1113.0;51104289
2021-12-20;1856;2032;71790;1553.0;51106145
2021-12-20;391;74;12;-1465.0;51106536
2021-12-21;390;403;9792;-1.0;51106926
2021-12-21;20296;19628;365748;19906.0;51127222
2021-12-21;2434;2866;37626;-17862.0;51129656
2021-12-21;3015;3070;66652;581.0;51132671
2021-12-21;0;7;8;-3015.0;51132671
2021-12-21;2415;2443;83752;2415.0;51135086
2021-12-21;3802;3962;49088;1387.0;51138888
2021-12-21;417;41;0;-3385.0;51139305
2021-12-21;3371;2452;3780;2954.0;51142676
2021-12-21;1798;2084;20393;-1573.0;51144474
2021-12-21;432;461;20052;-1366.0;51144906
2021-12-21;277;312;7525;-155.0;51145183
2021-12-21;471;69;8;194.0;51145654
2021-12-21;638;650;28605;167.0;51146292
2021-12-21;836;808;38467;198.0;51147128
2021-12-22;233;253;5679;-603.0;51147361
2021-12-22;5;13;9;-228.0;51147366
2021-12-22;342;318;7283;337.0;51147708
2021-12-22;1071;107;4;729.0;51148779
2021-12-22;3520;3084;3748;2449.0;51152299
2021-12-22;435;413;14821;-3085.0;51152734
2021-12-22;2372;2810;35561;1937.0;51155106
2021-12-22;2210;2197;72416;-162.0;51157316
2021-12-22;1205;147;8;-1005.0;51158521
2021-12-22;727;699;30367;-478.0;51159248
2021-12-22;3488;3618;43921;2761.0;51162736
2021-12-22;1705;1999;19084;-1783.0;51164441
2021-12-22;555;558;21354;-1150.0;51164996
2021-12-22;20618;19094;314777;20063.0;51185614
2021-12-22;2750;2878;60522;-17868.0;51188364
2021-12-23;2747;1892;3200;-3.0;51191111
2021-12-23;669;647;23350;-2078.0;51191780
2021-12-23;822;75;3;153.0;51192602
2021-12-23;480;455;15382;-342.0;51193082
2021-12-23;17998;15734;252924;17518.0;51211080
2021-12-23;5;12;13;-17993.0;51211085
2021-12-23;2316;2548;32281;2311.0;51213401
2021-12-23;2557;2422;48115;241.0;51215958
2021-12-23;366;357;10912;-2191.0;51216324
2021-12-23;3170;3182;35677;2804.0;51219494
2021-12-23;296;267;5563;-2874.0;51219790
2021-12-23;1926;1816;57522;1630.0;51221716
2021-12-23;191;199;4283;-1735.0;51221907
2021-12-23;904;103;7;713.0;51222811
2021-12-23;1549;1759;16616;645.0;51224360
2021-12-24;207;19;1;-1342.0;51224567
2021-12-24;57;71;964;-150.0;51224624
2021-12-24;626;680;14673;569.0;51225250
2021-12-24;107;157;2949;-519.0;51225357
2021-12-24;193;211;4958;86.0;51225550
2021-12-24;5757;6233;66931;5564.0;51231307
2021-12-24;573;784;5717;-5184.0;51231880
2021-12-24;5;5;4;-568.0;51231885
2021-12-24;778;651;1064;773.0;51232663
2021-12-24;90;95;1235;-688.0;51232753
2021-12-24;1089;1416;10253;999.0;51233842
2021-12-24;105;116;2091;-984.0;51233947
2021-12-24;874;1045;10145;769.0;51234821
2021-12-24;220;45;2;-654.0;51235041
2021-12-24;833;938;12875;613.0;51235874
2021-12-25;6;15;51;-827.0;51235880
2021-12-25;10;18;121;4.0;51235890
2021-12-25;5;12;80;-5.0;51235895
2021-12-25;42;209;885;37.0;51235937
2021-12-25;48;168;617;6.0;51235985
2021-12-25;4;10;38;-44.0;51235989
2021-12-25;1;0;2;-3.0;51235990
2021-12-25;415;1166;4724;414.0;51236405
2021-12-25;62;187;819;-353.0;51236467
2021-12-25;43;105;795;-19.0;51236510
2021-12-25;20;5;0;-23.0;51236530
2021-12-25;18;11;2;-2.0;51236548
2021-12-25;92;326;948;74.0;51236640
2021-12-25;60;76;142;-32.0;51236700
2021-12-25;4;24;224;-56.0;51236704
2021-12-26;336;401;4881;332.0;51237040
2021-12-26;186;29;3;-150.0;51237226
2021-12-26;2450;2486;29708;2264.0;51239676
2021-12-26;1;3;3;-2449.0;51239677
2021-12-26;56;60;1509;55.0;51239733
2021-12-26;351;399;6545;295.0;51240084
2021-12-26;355;279;510;4.0;51240439
2021-12-26;31;41;482;-324.0;51240470
2021-12-26;440;603;5769;409.0;51240910
2021-12-26;29;20;256;-411.0;51240939
2021-12-26;228;243;6137;199.0;51241167
2021-12-26;44;44;695;-184.0;51241211
2021-12-26;24;27;203;-20.0;51241235
2021-12-26;218;309;2715;194.0;51241453
2021-12-26;151;28;0;-67.0;51241604
2021-12-27;1907;2592;35567;1756.0;51243511
2021-12-27;6;11;3;-1901.0;51243517
2021-12-27;2568;2420;4351;2562.0;51246085
2021-12-27;305;412;10865;-2263.0;51246390
2021-12-27;496;584;17328;191.0;51246886
2021-12-27;1629;1959;54989;1133.0;51248515
2021-12-27;1406;1880;18763;-223.0;51249921
2021-12-27;2037;2658;51917;631.0;51251958
2021-12-27;204;212;3365;-1833.0;51252162
2021-12-27;1173;184;17;969.0;51253335
2021-12-27;1125;113;0;-48.0;51254460
2021-12-27;2557;3526;40480;1432.0;51257017
2021-12-27;15825;17046;247617;13268.0;51272842
2021-12-27;265;327;7251;-15560.0;51273107
2021-12-27;147;168;2721;-118.0;51273254
2021-12-28;2361;2810;40947;2214.0;51275615
2021-12-28;1454;183;10;-907.0;51277069
2021-12-28;12;17;9;-1442.0;51277081
2021-12-28;1671;1940;21352;1659.0;51278752
2021-12-28;2003;2016;68271;332.0;51280755
2021-12-28;3198;2229;5389;1195.0;51283953
2021-12-28;451;533;15546;-2747.0;51284404
2021-12-28;634;688;23947;183.0;51285038
2021-12-28;3344;3666;48976;2710.0;51288382
2021-12-28;19972;17965;308051;16628.0;51308354
2021-12-28;215;231;4307;-19757.0;51308569
2021-12-28;2633;2856;62902;2418.0;51311202
2021-12-28;339;381;10966;-2294.0;51311541
2021-12-28;289;300;5429;-50.0;51311830
2021-12-28;1368;115;0;1079.0;51313198
2021-12-29;2203;2481;37912;835.0;51315401
2021-12-29;3148;3375;45425;945.0;51318549
2021-12-29;191;207;3548;-2957.0;51318740
2021-12-29;1850;1779;59219;1659.0;51320590
2021-12-29;273;305;8440;-1577.0;51320863
2021-12-29;2155;211;3;1882.0;51323018
2021-12-29;387;413;12623;-1768.0;51323405
2021-12-29;8;12;6;-379.0;51323413
2021-12-29;2382;2447;57880;2374.0;51325795
2021-12-29;2252;271;13;-130.0;51328047
2021-12-29;20434;16897;275128;18182.0;51348481
2021-12-29;3216;2667;5543;-17218.0;51351697
2021-12-29;1554;1848;20046;-1662.0;51353251
2021-12-29;258;287;4356;-1296.0;51353509
2021-12-29;557;594;20114;299.0;51354066
2021-12-30;403;411;10356;-154.0;51354469
2021-12-30;1341;126;2;938.0;51355810
2021-12-30;1580;1689;16749;239.0;51357390
2021-12-30;6;10;4;-1574.0;51357396
2021-12-30;1435;182;14;1429.0;51358831
2021-12-30;2161;2389;30859;726.0;51360992
2021-12-30;18667;15282;233764;16506.0;51379659
2021-12-30;2362;2356;49631;-16305.0;51382021
2021-12-30;3026;3161;38957;664.0;51385047
2021-12-30;3136;2020;4726;110.0;51388183
2021-12-30;310;317;7362;-2826.0;51388493
2021-12-30;258;223;4093;-52.0;51388751
2021-12-30;1891;1665;50686;1633.0;51390642
2021-12-30;586;520;17106;-1305.0;51391228
2021-12-30;172;213;3219;-414.0;51391400
2021-12-31;36;50;850;-136.0;51391436
2021-12-31;863;931;14678;827.0;51392299
2021-12-31;533;709;5019;-330.0;51392832
2021-12-31;125;104;1808;-408.0;51392957
2021-12-31;439;78;9;314.0;51393396
2021-12-31;171;170;4188;-268.0;51393567
2021-12-31;432;49;2;261.0;51393999
2021-12-31;1145;1307;12036;713.0;51395144
2021-12-31;6298;5953;65792;5153.0;51401442
2021-12-31;2;4;0;-6296.0;51401444
2021-12-31;626;908;8177;624.0;51402070
2021-12-31;77;92;1207;-549.0;51402147
2021-12-31;124;124;2442;47.0;51402271
2021-12-31;1050;727;1337;926.0;51403321
2021-12-31;675;700;14039;-375.0;51403996
2022-01-01;3;6;49;-672.0;51403999
2022-01-01;0;1;1;-3.0;51403999
2022-01-01;60;7;0;60.0;51404059
2022-01-01;14;23;119;-46.0;51404073
2022-01-01;9;5;79;-5.0;51404082
2022-01-01;49;13;2;40.0;51404131
2022-01-01;859;993;4958;810.0;51404990
2022-01-01;192;274;1149;-667.0;51405182
2022-01-01;89;67;147;-103.0;51405271
2022-01-01;91;172;729;2.0;51405362
2022-01-01;10;18;90;-81.0;51405372
2022-01-01;26;23;237;16.0;51405398
2022-01-01;99;138;482;73.0;51405497
2022-01-01;138;157;1077;39.0;51405635
2022-01-01;79;89;797;-59.0;51405714
2022-01-02;310;370;5345;231.0;51406024
2022-01-02;389;49;0;79.0;51406413
2022-01-02;357;425;7692;-32.0;51406770
2022-01-02;39;35;700;-318.0;51406809
2022-01-02;3095;2632;33455;3056.0;51409904
2022-01-02;427;384;813;-2668.0;51410331
2022-01-02;64;75;1379;-363.0;51410395
2022-01-02;282;336;3341;218.0;51410677
2022-01-02;407;37;1;125.0;51411084
2022-01-02;35;34;470;-372.0;51411119
2022-01-02;0;3;0;-35.0;51411119
2022-01-02;23;27;183;23.0;51411142
2022-01-02;228;250;5788;205.0;51411370
2022-01-02;511;576;7461;283.0;51411881
2022-01-02;23;31;282;-488.0;51411904
2022-01-03;337;431;8744;314.0;51412241
2022-01-03;192;242;3469;-145.0;51412433
2022-01-03;14;14;13;-178.0;51412447
2022-01-03;1983;1727;2900;1969.0;51414430
2022-01-03;2989;3359;60030;1006.0;51417419
2022-01-03;2123;2245;54855;-866.0;51419542
2022-01-03;2969;2854;32041;846.0;51422511
2022-01-03;231;276;4141;-2738.0;51422742
2022-01-03;658;736;19902;427.0;51423400
2022-01-03;837;98;8;179.0;51424237
2022-01-03;887;110;21;50.0;51425124
2022-01-03;2457;2431;22982;1570.0;51427581
2022-01-03;466;511;13242;-1991.0;51428047
2022-01-03;4391;4368;53315;3925.0;51432438
2022-01-03;20534;19402;275663;16143.0;51452972
2022-01-04;309;313;5532;-20225.0;51453281
2022-01-04;4362;4605;64004;4053.0;51457643
2022-01-04;2339;2376;26320;-2023.0;51459982
2022-01-04;2345;1891;3349;6.0;51462327
2022-01-04;609;649;20303;-1736.0;51462936
2022-01-04;363;420;6840;-246.0;51463299
2022-01-04;8;5;7;-355.0;51463307
2022-01-04;490;524;13729;482.0;51463797
2022-01-04;870;878;30121;380.0;51464667
2022-01-04;834;86;4;-36.0;51465501
2022-01-04;21926;20879;350243;21092.0;51487427
2022-01-04;2764;2995;35726;-19162.0;51490191
2022-01-04;815;129;21;-1949.0;51491006
2022-01-04;2463;2492;71838;1648.0;51493469
2022-01-04;3355;3516;72449;892.0;51496824
2022-01-05;2925;3076;63841;-430.0;51499749
2022-01-05;541;531;14903;-2384.0;51500290
2022-01-05;2062;2313;25650;1521.0;51502352
2022-01-05;31211;22189;304193;29149.0;51533563
2022-01-05;4984;4077;4862;-26227.0;51538547
2022-01-05;5049;481;4;65.0;51543596
2022-01-05;5109;636;17;60.0;51548705
2022-01-05;3933;4019;55933;-1176.0;51552638
2022-01-05;236;236;4163;-3697.0;51552874
2022-01-05;2721;3054;36091;2485.0;51555595
2022-01-05;392;413;10120;-2329.0;51555987
2022-01-05;737;711;22956;345.0;51556724
2022-01-05;2197;2235;60166;1460.0;51558921
2022-01-05;11;7;4;-2186.0;51558932
2022-01-05;314;400;5483;303.0;51559246
2022-01-06;2331;1915;3760;2017.0;51561577
2022-01-06;22797;20248;345559;20466.0;51584374
2022-01-06;4420;4361;64677;-18377.0;51588794
2022-01-06;5;7;8;-4415.0;51588799
2022-01-06;2769;2937;37872;2764.0;51591568
2022-01-06;2636;2409;69001;-133.0;51594204
2022-01-06;476;422;6962;-2160.0;51594680
2022-01-06;921;838;27879;445.0;51595601
2022-01-06;668;625;18589;-253.0;51596269
2022-01-06;2242;2364;27434;1574.0;51598511
2022-01-06;3457;3294;71291;1215.0;51601968
2022-01-06;527;490;12872;-2930.0;51602495
2022-01-06;999;131;2;472.0;51603494
2022-01-06;307;285;5203;-692.0;51603801
2022-01-06;1039;170;9;732.0;51604840
2022-01-07;3;8;4;-1036.0;51604843
2022-01-07;437;494;6448;434.0;51605280
2022-01-07;3778;3711;83968;3341.0;51609058
2022-01-07;3249;3524;43555;-529.0;51612307
2022-01-07;474;461;11671;-2775.0;51612781
2022-01-07;673;657;17154;199.0;51613454
2022-01-07;26372;23804;384201;25699.0;51639826
2022-01-07;240;320;4708;-26132.0;51640066
2022-01-07;2855;2788;80455;2615.0;51642921
2022-01-07;2534;2529;30174;-321.0;51645455
2022-01-07;928;918;26476;-1606.0;51646383
2022-01-07;3442;2903;5876;2514.0;51649825
2022-01-07;1340;180;9;-2102.0;51651165
2022-01-07;1370;216;22;30.0;51652535
2022-01-07;5049;5095;73681;3679.0;51657584
2022-01-08;23419;18256;237022;18370.0;51681003
2022-01-08;435;480;11722;-22984.0;51681438
2022-01-08;3857;3392;6833;3422.0;51685295
2022-01-08;188;218;2508;-3669.0;51685483
2022-01-08;148;130;1960;-40.0;51685631
2022-01-08;248;254;4180;100.0;51685879
2022-01-08;293;351;6457;45.0;51686172
2022-01-08;3543;499;0;3250.0;51689715
2022-01-08;2281;2639;38980;-1262.0;51691996
2022-01-08;1678;1863;20919;-603.0;51693674
2022-01-08;9;8;2;-1669.0;51693683
2022-01-08;1659;1818;46946;1650.0;51695342
2022-01-08;2287;2641;51984;628.0;51697629
2022-01-08;3019;3368;44521;732.0;51700648
2022-01-08;3774;595;10;755.0;51704422
2022-01-09;1601;319;5;-2173.0;51706023
2022-01-09;756;831;15985;-845.0;51706779
2022-01-09;1112;809;1845;356.0;51707891
2022-01-09;43;44;547;-1069.0;51707934
2022-01-09;60;76;987;17.0;51707994
2022-01-09;79;95;1528;19.0;51708073
2022-01-09;1000;1173;15798;921.0;51709073
2022-01-09;761;950;13625;-239.0;51709834
2022-01-09;1473;285;1;712.0;51711307
2022-01-09;479;490;11997;-994.0;51711786
2022-01-09;133;129;2801;-346.0;51711919
2022-01-09;8115;5969;73819;7982.0;51720034
2022-01-09;26;27;447;-8089.0;51720060
2022-01-09;0;1;1;-26.0;51720060
2022-01-09;592;740;8252;592.0;51720652
2022-01-10;2566;3600;35058;1974.0;51723218
2022-01-10;7;27;11;-2559.0;51723225
2022-01-10;18484;22945;259625;18477.0;51741709
2022-01-10;462;569;10989;-18022.0;51742171
2022-01-10;2630;3741;52932;2168.0;51744801
2022-01-10;1851;2517;47662;-779.0;51746652
2022-01-10;953;255;9;-898.0;51747605
2022-01-10;269;316;3731;-684.0;51747874
2022-01-10;2051;2889;25376;1782.0;51749925
2022-01-10;350;457;7426;-1701.0;51750275
2022-01-10;680;792;17771;330.0;51750955
2022-01-10;183;266;3120;-497.0;51751138
2022-01-10;3573;5259;52339;3390.0;51754711
2022-01-10;1982;1991;3189;-1591.0;51756693
2022-01-10;927;266;12;-1055.0;51757620
2022-01-11;3008;3375;58842;2081.0;51760628
2022-01-11;247;293;4466;-2761.0;51760875
2022-01-11;5;13;12;-242.0;51760880
2022-01-11;21510;21763;297608;21505.0;51782390
2022-01-11;634;684;15250;-20876.0;51783024
2022-01-11;981;206;7;347.0;51784005
2022-01-11;2340;1906;3735;1359.0;51786345
2022-01-11;2975;3451;37075;635.0;51789320
2022-01-11;2290;2532;56999;-685.0;51791610
2022-01-11;427;429;5773;-1863.0;51792037
2022-01-11;1012;187;4;585.0;51793049
2022-01-11;844;831;22754;-168.0;51793893
2022-01-11;476;515;10307;-368.0;51794369
2022-01-11;2215;2665;26664;1739.0;51796584
2022-01-11;4056;4676;55720;1841.0;51800640
2022-01-12;4745;4431;5316;689.0;51805385
2022-01-12;483;554;10281;-4262.0;51805868
2022-01-12;347;398;7184;-136.0;51806215
2022-01-12;5771;1355;3;5424.0;51811986
2022-01-12;3215;4220;44834;-2556.0;51815201
2022-01-12;7;8;1;-3208.0;51815208
2022-01-12;2397;3307;48009;2390.0;51817605
2022-01-12;1905;2542;23300;-492.0;51819510
2022-01-12;668;732;16152;-1237.0;51820178
2022-01-12;1900;2302;43366;1232.0;51822078
2022-01-12;298;343;4095;-1602.0;51822376
2022-01-12;2679;3454;33714;2381.0;51825055
2022-01-12;30785;25422;239481;28106.0;51855840
2022-01-12;6176;1551;17;-24609.0;51862016
2022-01-12;194;225;3209;-5982.0;51862210
2022-01-13;2537;3233;51901;2343.0;51864747
2022-01-13;1116;290;3;-1421.0;51865863
2022-01-13;1938;2407;23839;822.0;51867801
2022-01-13;1935;2388;49199;-3.0;51869736
2022-01-13;537;599;12342;-1398.0;51870273
2022-01-13;2659;3452;34859;2122.0;51872932
2022-01-13;413;450;5223;-2246.0;51873345
2022-01-13;245;241;3812;-168.0;51873590
2022-01-13;3506;4410;50090;3261.0;51877096
2022-01-13;5;11;2;-3501.0;51877101
2022-01-13;434;450;8531;429.0;51877535
2022-01-13;742;785;18808;308.0;51878277
2022-01-13;19565;21148;262538;18823.0;51897842
2022-01-13;2365;2063;3909;-17200.0;51900207
2022-01-13;1133;369;20;-1232.0;51901340
2022-01-14;266;249;3552;-867.0;51901606
2022-01-14;362;364;4938;96.0;51901968
2022-01-14;2225;2518;59787;1863.0;51904193
2022-01-14;4;9;5;-2221.0;51904197
2022-01-14;2935;3586;42803;2931.0;51907132
2022-01-14;2116;2583;28021;-819.0;51909248
2022-01-14;21620;22505;307520;19504.0;51930868
2022-01-14;383;389;7946;-21237.0;51931251
2022-01-14;1353;356;10;970.0;51932604
2022-01-14;2741;3447;64234;1388.0;51935345
2022-01-14;1297;300;2;-1444.0;51936642
2022-01-14;3782;4665;60132;2485.0;51940424
2022-01-14;550;568;11697;-3232.0;51940974
2022-01-14;2934;2683;5668;2384.0;51943908
2022-01-14;672;788;18725;-2262.0;51944580
2022-01-15;3676;824;2;3004.0;51948256
2022-01-15;1407;1733;19414;-2269.0;51949663
2022-01-15;2315;2886;36539;908.0;51951978
2022-01-15;228;249;4185;-2087.0;51952206
2022-01-15;100;105;1369;-128.0;51952306
2022-01-15;161;191;2828;61.0;51952467
2022-01-15;171;154;1769;10.0;51952638
2022-01-15;3;5;5;-168.0;51952641
2022-01-15;2056;2607;37849;2053.0;51954697
2022-01-15;1185;1457;34136;-871.0;51955882
2022-01-15;3981;958;14;2796.0;51959863
2022-01-15;339;406;8021;-3642.0;51960202
2022-01-15;20326;16545;192240;19987.0;51980528
2022-01-15;3048;2822;6511;-17278.0;51983576
2022-01-15;1656;2148;39598;-1392.0;51985232
2022-01-16;716;863;10453;-940.0;51985948
2022-01-16;80;97;1780;-636.0;51986028
2022-01-16;61;50;928;-19.0;51986089
2022-01-16;36;48;373;-25.0;51986125
2022-01-16;745;579;1454;709.0;51986870
2022-01-16;444;580;10154;-301.0;51987314
2022-01-16;421;529;6268;-23.0;51987735
2022-01-16;38;35;597;-383.0;51987773
2022-01-16;5963;4693;50766;5925.0;51993736
2022-01-16;18;36;276;-5945.0;51993754
2022-01-16;4;2;0;-14.0;51993758
2022-01-16;1289;360;6;1285.0;51995047
2022-01-16;644;834;10805;-645.0;51995691
2022-01-16;282;366;7670;-362.0;51995973
2022-01-16;1185;314;2;903.0;51997158
2022-01-17;284;369;7047;-901.0;51997442
2022-01-17;582;283;0;298.0;51998024
2022-01-17;2106;2396;27771;1524.0;52000130
2022-01-17;2410;3086;35489;304.0;52002540
2022-01-17;1532;1388;2772;-878.0;52004072
2022-01-17;639;311;16;-893.0;52004711
2022-01-17;209;283;4875;-430.0;52004920
2022-01-17;1577;2208;35285;1368.0;52006497
2022-01-17;377;536;10848;-1200.0;52006874
2022-01-17;188;229;2563;-189.0;52007062
2022-01-17;12710;14683;178688;12522.0;52019772
2022-01-17;1186;1636;30914;-11524.0;52020958
2022-01-17;1511;1789;19065;325.0;52022469
2022-01-17;1;10;8;-1510.0;52022470
2022-01-17;108;159;2035;107.0;52022578
2022-01-18;560;652;13763;452.0;52023138
2022-01-18;294;337;3990;-266.0;52023432
2022-01-18;2668;3402;37106;2374.0;52026100
2022-01-18;14618;16650;196376;11950.0;52040718
2022-01-18;1625;1584;2865;-12993.0;52042343
2022-01-18;2253;2655;26429;628.0;52044596
2022-01-18;657;327;8;-1596.0;52045253
2022-01-18;610;318;4;-47.0;52045863
2022-01-18;168;216;3115;-442.0;52046031
2022-01-18;1;3;2;-167.0;52046032
2022-01-18;1675;1914;18513;1674.0;52047707
2022-01-18;1440;1913;36019;-235.0;52049147
2022-01-18;413;461;9558;-1027.0;52049560
2022-01-18;1930;2508;38394;1517.0;52051490
2022-01-18;324;360;6610;-1606.0;52051814
2022-01-19;4;7;2;-320.0;52051818
2022-01-19;1092;1660;25747;1088.0;52052910
2022-01-19;22006;20674;150079;20914.0;52074916
2022-01-19;1331;1812;15310;-20675.0;52076247
2022-01-19;4505;2194;13;3174.0;52080752
2022-01-19;1994;2493;23127;-2511.0;52082746
2022-01-19;213;267;2796;-1781.0;52082959
2022-01-19;191;279;4322;-22.0;52083150
2022-01-19;384;521;9192;193.0;52083534
2022-01-19;3322;3471;4068;2938.0;52086856
2022-01-19;298;371;6163;-3024.0;52087154
2022-01-19;1412;2193;29038;1114.0;52088566
2022-01-19;5155;2261;21;3743.0;52093721
2022-01-19;1981;2962;28204;-3174.0;52095702
2022-01-19;124;183;2076;-1857.0;52095826
2022-01-20;452;571;10900;328.0;52096278
2022-01-20;513;325;3;61.0;52096791
2022-01-20;12177;15191;161195;11664.0;52108968
2022-01-20;332;457;7533;-11845.0;52109300
2022-01-20;1514;2278;31459;1182.0;52110814
2022-01-20;2278;3101;30926;764.0;52113092
2022-01-20;1286;1684;14817;-992.0;52114378
2022-01-20;147;218;2507;-1139.0;52114525
2022-01-20;278;348;5439;131.0;52114803
2022-01-20;1461;1465;2870;1183.0;52116264
2022-01-20;1233;1712;28880;-228.0;52117497
2022-01-20;4;7;8;-1229.0;52117501
2022-01-20;258;328;3633;254.0;52117759
2022-01-20;1856;2305;22210;1598.0;52119615
2022-01-20;565;392;10;-1291.0;52120180
2022-01-21;2163;2625;28954;1598.0;52122343
2022-01-21;783;459;5;-1380.0;52123126
2022-01-21;479;567;10830;-304.0;52123605
2022-01-21;14644;17248;199548;14165.0;52138249
2022-01-21;2129;2275;5979;-12515.0;52140378
2022-01-21;1735;2505;40753;-394.0;52142113
2022-01-21;290;290;3351;-1445.0;52142403
2022-01-21;275;316;5094;-15.0;52142678
2022-01-21;294;369;7214;19.0;52142972
2022-01-21;10;4;4;-284.0;52142982
2022-01-21;1487;1800;18936;1477.0;52144469
2022-01-21;1407;1925;36394;-80.0;52145876
2022-01-21;144;199;2509;-1263.0;52146020
2022-01-21;883;505;17;739.0;52146903
2022-01-21;2565;3409;39508;1682.0;52149468
2022-01-22;68;62;815;-2497.0;52149536
2022-01-22;122;172;2472;54.0;52149658
2022-01-22;1103;1660;24508;981.0;52150761
2022-01-22;2648;1200;5;1545.0;52153409
2022-01-22;2957;1251;17;309.0;52156366
2022-01-22;4;9;3;-2953.0;52156370
2022-01-22;1013;1341;13131;1009.0;52157383
2022-01-22;1580;2155;25736;567.0;52158963
2022-01-22;2233;2506;7142;653.0;52161196
2022-01-22;218;262;4505;-2015.0;52161414
2022-01-22;1519;2285;23226;1301.0;52162933
2022-01-22;89;101;1252;-1430.0;52163022
2022-01-22;99;121;1696;10.0;52163121
2022-01-22;808;1255;19989;709.0;52163929
2022-01-22;14461;14380;124497;13653.0;52178390
2022-01-23;3484;3971;28285;-10977.0;52181874
2022-01-23;1;2;1;-3483.0;52181875
2022-01-23;710;506;6;709.0;52182585
2022-01-23;393;612;5887;-317.0;52182978
2022-01-23;23;33;317;-370.0;52183001
2022-01-23;50;65;912;27.0;52183051
2022-01-23;430;570;5929;380.0;52183481
2022-01-23;275;445;5323;-155.0;52183756
2022-01-23;162;274;3776;-113.0;52183918
2022-01-23;22;45;521;-140.0;52183940
2022-01-23;12;18;164;-10.0;52183952
2022-01-23;267;394;3469;255.0;52184219
2022-01-23;468;506;1739;201.0;52184687
2022-01-23;21;32;241;-447.0;52184708
2022-01-23;650;469;0;629.0;52185358
2022-01-24;1105;1906;22744;455.0;52186463
2022-01-24;183;335;4327;-922.0;52186646
2022-01-24;119;177;1797;-64.0;52186765
2022-01-24;289;396;5;170.0;52187054
2022-01-24;2;6;6;-287.0;52187056
2022-01-24;123;263;2985;121.0;52187179
2022-01-24;800;1441;18697;677.0;52187979
2022-01-24;256;500;6335;-544.0;52188235
2022-01-24;1620;2740;24205;1364.0;52189855
2022-01-24;1527;2200;18555;-93.0;52191382
2022-01-24;8496;13360;120392;6969.0;52199878
2022-01-24;78;136;1504;-8418.0;52199956
2022-01-24;1024;1222;6089;946.0;52200980
2022-01-24;1053;1631;13125;29.0;52202033
2022-01-24;317;407;18;-736.0;52202350
2022-01-25;327;426;22;10.0;52202677
2022-01-25;117;228;1999;-210.0;52202794
2022-01-25;5;8;4;-112.0;52202799
2022-01-25;1130;1689;12471;1125.0;52203929
2022-01-25;1076;1648;22502;-54.0;52205005
2022-01-25;1284;2171;24898;208.0;52206289
2022-01-25;276;463;5903;-1008.0;52206565
2022-01-25;334;445;7;58.0;52206899
2022-01-25;336;591;8212;2.0;52207235
2022-01-25;1615;2196;17849;1279.0;52208850
2022-01-25;1843;2941;25022;228.0;52210693
2022-01-25;9859;14958;132162;8016.0;52220552
2022-01-25;1147;1526;6384;-8712.0;52221699
2022-01-25;194;341;4155;-953.0;52221893
2022-01-25;175;285;2734;-19.0;52222068
2022-01-26;771;1340;16399;596.0;52222839
2022-01-26;994;1850;19701;223.0;52223833
2022-01-26;2977;3543;54;1983.0;52226810
2022-01-26;14253;21140;111248;11276.0;52241063
2022-01-26;2297;3297;14018;-11956.0;52243360
2022-01-26;279;484;5734;-2018.0;52243639
2022-01-26;4;9;3;-275.0;52243643
2022-01-26;87;161;1395;83.0;52243730
2022-01-26;142;264;2740;55.0;52243872
2022-01-26;898;1479;10232;756.0;52244770
2022-01-26;2575;3516;5;1677.0;52247345
2022-01-26;138;243;1845;-2437.0;52247483
2022-01-26;1404;2546;19603;1266.0;52248887
2022-01-26;197;352;3806;-1207.0;52249084
2022-01-26;1490;2056;15713;1293.0;52250574
2022-01-27;1326;1936;15280;-164.0;52251900
2022-01-27;155;310;3197;-1171.0;52252055
2022-01-27;8382;13577;110606;8227.0;52260437
2022-01-27;1036;1969;21044;-7346.0;52261473
2022-01-27;1448;2497;21386;412.0;52262921
2022-01-27;323;511;2;-1125.0;52263244
2022-01-27;226;386;4502;-97.0;52263470
2022-01-27;841;1531;18338;615.0;52264311
2022-01-27;1;2;3;-840.0;52264312
2022-01-27;383;507;25;382.0;52264695
2022-01-27;114;168;1471;-269.0;52264809
2022-01-27;907;1429;10463;793.0;52265716
2022-01-27;283;557;6333;-624.0;52265999
2022-01-27;1157;1532;6346;874.0;52267156
2022-01-27;182;242;2216;-975.0;52267338
2022-01-28;164;352;2305;-18.0;52267502
2022-01-28;127;229;1775;-37.0;52267629
2022-01-28;1995;4544;31828;1868.0;52269624
2022-01-28;1048;2558;26548;-947.0;52270672
2022-01-28;206;429;3483;-842.0;52270878
2022-01-28;1734;2938;11498;1528.0;52272612
2022-01-28;413;982;2;-1321.0;52273025
2022-01-28;1222;2569;14893;809.0;52274247
2022-01-28;11158;23663;158680;9936.0;52285405
2022-01-28;353;756;7662;-10805.0;52285758
2022-01-28;506;969;27;153.0;52286264
2022-01-28;243;527;5080;-263.0;52286507
2022-01-28;1397;3363;31276;1154.0;52287904
2022-01-28;4;5;3;-1393.0;52287908
2022-01-28;1746;3442;22300;1742.0;52289654
2022-01-29;1661;3053;16136;-85.0;52291315
2022-01-29;142;327;3114;-1519.0;52291457
2022-01-29;1679;2377;50;1537.0;52293136
2022-01-29;51;97;588;-1628.0;52293187
2022-01-29;97;188;1786;46.0;52293284
2022-01-29;1527;2345;7;1430.0;52294811
2022-01-29;1070;2085;19494;-457.0;52295881
2022-01-29;747;1678;18915;-323.0;52296628
2022-01-29;2;6;2;-745.0;52296630
2022-01-29;554;1247;14429;552.0;52297184
2022-01-29;1108;2229;18614;554.0;52298292
2022-01-29;9487;17451;105454;8379.0;52307779
2022-01-29;70;151;1167;-9417.0;52307849
2022-01-29;72;141;813;2.0;52307921
2022-01-29;707;1527;10339;635.0;52308628
2022-01-30;185;428;2540;-522.0;52308813
2022-01-30;23;38;318;-162.0;52308836
2022-01-30;125;287;2669;102.0;52308961
2022-01-30;354;619;3462;229.0;52309315
2022-01-30;7;24;119;-347.0;52309322
2022-01-30;2303;4792;23078;2296.0;52311625
2022-01-30;181;387;4114;-2122.0;52311806
2022-01-30;19;35;237;-162.0;52311825
2022-01-30;286;604;4630;267.0;52312111
2022-01-30;11;28;166;-275.0;52312122
2022-01-30;396;876;10;385.0;52312518
2022-01-30;376;836;4;-20.0;52312894
2022-01-30;38;79;571;-338.0;52312932
2022-01-30;300;547;4236;262.0;52313232
2022-01-30;2;4;2;-298.0;52313234
2022-01-31;108;249;1796;106.0;52313342
2022-01-31;139;316;2635;31.0;52313481
2022-01-31;162;513;10;23.0;52313643
2022-01-31;756;1429;4095;594.0;52314399
2022-01-31;519;1396;12139;-237.0;52314918
2022-01-31;160;527;1;-359.0;52315078
2022-01-31;1097;2707;18181;937.0;52316175
2022-01-31;5816;13898;83624;4719.0;52321991
2022-01-31;748;1886;16075;-5068.0;52322739
2022-01-31;73;183;1058;-675.0;52322812
2022-01-31;744;1792;9595;671.0;52323556
2022-01-31;1065;2313;13225;321.0;52324621
2022-01-31;0;4;2;-1065.0;52324621
2022-01-31;178;451;3899;178.0;52324799
2022-01-31;67;132;913;-111.0;52324866
2022-02-01;1356;2781;20068;1289.0;52326222
2022-02-01;6955;14222;96635;5599.0;52333177
2022-02-01;119;319;2603;-6836.0;52333296
2022-02-01;129;251;1647;10.0;52333425
2022-02-01;190;494;3;61.0;52333615
2022-02-01;668;1513;15124;478.0;52334283
2022-02-01;238;563;5275;-430.0;52334521
2022-02-01;4;7;3;-234.0;52334525
2022-02-01;1246;2228;13976;1242.0;52335771
2022-02-01;834;1334;4062;-412.0;52336605
2022-02-01;793;1697;10124;-41.0;52337398
2022-02-01;168;403;3732;-625.0;52337566
2022-02-01;914;1984;18793;746.0;52338480
2022-02-01;212;479;18;-702.0;52338692
2022-02-01;84;169;1207;-128.0;52338776
2022-02-02;10629;23764;95332;10545.0;52349405
2022-02-02;1194;2386;14704;-9435.0;52350599
2022-02-02;838;1800;10268;-356.0;52351437
2022-02-02;91;245;1298;-747.0;52351528
2022-02-02;209;484;4343;118.0;52351737
2022-02-02;816;1860;17223;607.0;52352553
2022-02-02;6;11;5;-810.0;52352559
2022-02-02;70;179;948;64.0;52352629
2022-02-02;1933;4440;37;1863.0;52354562
2022-02-02;115;264;2008;-1818.0;52354677
2022-02-02;152;378;2846;37.0;52354829
2022-02-02;601;1428;12993;449.0;52355430
2022-02-02;1635;3336;9659;1034.0;52357065
2022-02-02;1296;2636;18991;-339.0;52358361
2022-02-02;1673;4317;9;377.0;52360034
2022-02-03;138;325;2127;-1535.0;52360172
2022-02-03;167;514;15;29.0;52360339
2022-02-03;208;528;4486;41.0;52360547
2022-02-03;597;1412;13518;389.0;52361144
2022-02-03;738;1452;8924;141.0;52361882
2022-02-03;741;1284;3902;3.0;52362623
2022-02-03;1022;1992;12910;281.0;52363645
2022-02-03;1;4;7;-1021.0;52363646
2022-02-03;131;505;4;130.0;52363777
2022-02-03;68;176;1065;-63.0;52363845
2022-02-03;139;394;3033;71.0;52363984
2022-02-03;108;247;1459;-31.0;52364092
2022-02-03;814;1760;16792;706.0;52364906
2022-02-03;1267;2428;18764;453.0;52366173
2022-02-03;6139;13021;87006;4872.0;52372312
2022-02-04;1182;2359;8432;-4957.0;52373494
2022-02-04;245;876;4;-937.0;52373739
2022-02-04;125;352;2656;-120.0;52373864
2022-02-04;7555;19442;133763;7430.0;52381419
2022-02-04;80;226;1199;-7475.0;52381499
2022-02-04;705;2080;20699;625.0;52382204
2022-02-04;294;836;28;-411.0;52382498
2022-02-04;3;4;5;-291.0;52382501
2022-02-04;1333;3680;29075;1330.0;52383834
2022-02-04;984;2656;26841;-349.0;52384818
2022-02-04;158;463;3775;-826.0;52384976
2022-02-04;1223;2818;19809;1065.0;52386199
2022-02-04;145;358;1699;-1078.0;52386344
2022-02-04;834;2062;13771;689.0;52387178
2022-02-04;244;672;5770;-590.0;52387422
2022-02-05;951;2483;23;707.0;52388373
2022-02-05;599;1588;16181;-352.0;52388972
2022-02-05;80;206;1302;-519.0;52389052
2022-02-05;35;102;446;-45.0;52389087
2022-02-05;838;2457;5;803.0;52389925
2022-02-05;891;1991;17044;53.0;52390816
2022-02-05;127;321;2471;-764.0;52390943
2022-02-05;4;4;1;-123.0;52390947
2022-02-05;834;2156;17284;830.0;52391781
2022-02-05;573;1378;9731;-261.0;52392354
2022-02-05;60;156;855;-513.0;52392414
2022-02-05;6558;16689;88876;6498.0;52398972
2022-02-05;51;108;567;-6507.0;52399023
2022-02-05;400;1190;11602;349.0;52399423
2022-02-05;1115;2549;11364;715.0;52400538
2022-02-06;212;451;3402;-903.0;52400750
2022-02-06;23;35;228;-189.0;52400773
2022-02-06;8;31;104;-15.0;52400781
2022-02-06;2;2;1;-6.0;52400783
2022-02-06;130;351;3118;128.0;52400913
2022-02-06;136;278;2248;6.0;52401049
2022-02-06;190;450;1956;54.0;52401239
2022-02-06;15;58;398;-175.0;52401254
2022-02-06;10;36;129;-5.0;52401264
2022-02-06;69;219;1831;59.0;52401333
2022-02-06;1408;3840;17513;1339.0;52402741
2022-02-06;8;14;80;-1400.0;52402749
2022-02-06;186;688;2;178.0;52402935
2022-02-06;218;550;4010;32.0;52403153
2022-02-06;201;677;6;-17.0;52403354
2022-02-07;144;414;3376;-57.0;52403498
2022-02-07;80;226;1463;-64.0;52403578
2022-02-07;74;188;801;-6.0;52403652
2022-02-07;861;2641;20344;787.0;52404513
2022-02-07;110;331;2159;-751.0;52404623
2022-02-07;218;444;2;108.0;52404841
2022-02-07;841;2036;15742;623.0;52405682
2022-02-07;36;121;650;-805.0;52405718
2022-02-07;592;1803;16386;556.0;52406310
2022-02-07;407;1239;11140;-185.0;52406717
2022-02-07;760;1476;6834;353.0;52407477
2022-02-07;4952;12864;89846;4192.0;52412429
2022-02-07;2;3;4;-4950.0;52412431
2022-02-07;262;503;33;260.0;52412693
2022-02-07;565;1439;10912;303.0;52413258
2022-02-08;636;1173;5633;71.0;52413894
2022-02-08;4971;10857;92794;4335.0;52418865
2022-02-08;144;486;4449;-4827.0;52419009
2022-02-08;61;157;931;-83.0;52419070
2022-02-08;952;2103;20066;891.0;52420022
2022-02-08;459;1212;13847;-493.0;52420481
2022-02-08;535;1091;10241;76.0;52421016
2022-02-08;864;1468;14488;329.0;52421880
2022-02-08;89;251;1175;-775.0;52421969
2022-02-08;162;372;1;73.0;52422131
2022-02-08;99;291;2066;-63.0;52422230
2022-02-08;3;1;3;-96.0;52422233
2022-02-08;122;350;2983;119.0;52422355
2022-02-08;238;386;14;116.0;52422593
2022-02-08;607;1516;16897;369.0;52423200
2022-02-09;858;1881;19714;251.0;52424058
2022-02-09;7384;18155;96874;6526.0;52431442
2022-02-09;945;1670;16258;-6439.0;52432387
2022-02-09;2;3;4;-943.0;52432389
2022-02-09;1190;2611;9028;1188.0;52433579
2022-02-09;129;402;4222;-1061.0;52433708
2022-02-09;638;1145;10937;509.0;52434346
2022-02-09;51;156;764;-587.0;52434397
2022-02-09;388;1055;13846;337.0;52434785
2022-02-09;76;214;1608;-312.0;52434861
2022-02-09;583;1380;16752;507.0;52435444
2022-02-09;1281;3789;30;698.0;52436725
2022-02-09;109;280;2744;-1172.0;52436834
2022-02-09;1071;3390;5;962.0;52437905
2022-02-09;63;179;962;-1008.0;52437968
2022-02-10;65;137;853;2.0;52438033
2022-02-10;150;408;4366;85.0;52438183
2022-02-10;512;1396;14789;362.0;52438695
2022-02-10;733;1776;17377;221.0;52439428
2022-02-10;111;320;2779;-622.0;52439539
2022-02-10;176;305;3;65.0;52439715
2022-02-10;4276;9504;84078;4100.0;52443991
2022-02-10;726;1260;13351;-3550.0;52444717
2022-02-10;490;945;9130;-236.0;52445207
2022-02-10;0;1;2;-490.0;52445207
2022-02-10;167;361;13;167.0;52445374
2022-02-10;598;1079;4634;431.0;52445972
2022-02-10;91;219;1040;-507.0;52446063
2022-02-10;81;257;1679;-10.0;52446144
2022-02-10;376;1040;14062;295.0;52446520
2022-02-11;5454;13291;123461;5078.0;52451974
2022-02-11;190;551;1;-5264.0;52452164
2022-02-11;918;1739;19381;728.0;52453082
2022-02-11;145;518;5832;-773.0;52453227
2022-02-11;138;357;3294;-7.0;52453365
2022-02-11;233;576;30;95.0;52453598
2022-02-11;664;1758;22465;431.0;52454262
2022-02-11;88;281;2025;-576.0;52454350
2022-02-11;74;266;1176;-14.0;52454424
2022-02-11;493;1473;21052;419.0;52454917
2022-02-11;593;1331;13389;100.0;52455510
2022-02-11;903;1779;7974;310.0;52456413
2022-02-11;3;5;3;-900.0;52456416
2022-02-11;68;175;952;65.0;52456484
2022-02-11;944;2482;25887;876.0;52457428
2022-02-12;33;109;445;-911.0;52457461
2022-02-12;1;3;4;-32.0;52457462
2022-02-12;588;1317;15564;587.0;52458050
2022-02-12;627;1977;17;39.0;52458677
2022-02-12;374;1075;13592;-253.0;52459051
2022-02-12;79;231;2632;-295.0;52459130
2022-02-12;43;148;1325;-36.0;52459173
2022-02-12;571;1442;15546;528.0;52459744
2022-02-12;46;121;716;-525.0;52459790
2022-02-12;388;940;9082;342.0;52460178
2022-02-12;531;1869;5;143.0;52460709
2022-02-12;27;62;303;-504.0;52460736
2022-02-12;4205;11920;79250;4178.0;52464941
2022-02-12;243;811;11917;-3962.0;52465184
2022-02-12;654;1815;8102;411.0;52465838
2022-02-13;118;181;2045;-536.0;52465956
2022-02-13;20;26;447;-98.0;52465976
2022-02-13;106;213;2800;86.0;52466082
2022-02-13;149;226;3219;43.0;52466231
2022-02-13;134;423;0;-15.0;52466365
2022-02-13;12;22;246;-122.0;52466377
2022-02-13;2;1;0;-10.0;52466379
2022-02-13;163;307;3650;161.0;52466542
2022-02-13;6;22;83;-157.0;52466548
2022-02-13;6;17;121;0.0;52466554
2022-02-13;99;257;1412;93.0;52466653
2022-02-13;4;12;52;-95.0;52466657
2022-02-13;46;105;2100;42.0;52466703
2022-02-13;985;2290;16178;939.0;52467688
2022-02-13;120;478;3;-865.0;52467808
2022-02-14;1;2;0;-119.0;52467809
2022-02-14;543;1023;6711;542.0;52468352
2022-02-14;285;773;12429;-258.0;52468637
2022-02-14;426;852;10010;141.0;52469063
2022-02-14;96;276;3664;-330.0;52469159
2022-02-14;201;416;11;105.0;52469360
2022-02-14;418;943;14731;217.0;52469778
2022-02-14;598;1104;15743;180.0;52470376
2022-02-14;31;72;535;-567.0;52470407
2022-02-14;47;146;1170;16.0;52470454
2022-02-14;36;114;616;-11.0;52470490
2022-02-14;631;1420;18023;595.0;52471121
2022-02-14;64;189;2050;-567.0;52471185
2022-02-14;152;338;2;88.0;52471337
2022-02-14;3529;7668;85695;3377.0;52474866
2022-02-15;113;253;1;-3416.0;52474979
2022-02-15;0;0;0;-113.0;52474979
2022-02-15;612;1223;15411;612.0;52475591
2022-02-15;56;186;1543;-556.0;52475647
2022-02-15;3569;8148;84360;3513.0;52479216
2022-02-15;424;909;9818;-3145.0;52479640
2022-02-15;310;876;11924;-114.0;52479950
2022-02-15;31;107;699;-279.0;52479981
2022-02-15;447;1111;14640;416.0;52480428
2022-02-15;147;255;12;-300.0;52480575
2022-02-15;640;1450;17518;493.0;52481215
2022-02-15;54;199;840;-586.0;52481269
2022-02-15;81;270;2337;27.0;52481350
2022-02-15;532;955;5852;451.0;52481882
2022-02-15;122;354;3765;-410.0;52482004
2022-02-16;379;987;12068;257.0;52482383
2022-02-16;4;7;3;-375.0;52482387
2022-02-16;621;1306;16787;617.0;52483008
2022-02-16;752;1845;8681;131.0;52483760
2022-02-16;53;142;1177;-699.0;52483813
2022-02-16;78;303;2454;25.0;52483891
2022-02-16;676;2327;7;598.0;52484567
2022-02-16;430;920;9766;-246.0;52484997
2022-02-16;257;773;8464;-173.0;52485254
2022-02-16;875;2759;25;618.0;52486129
2022-02-16;45;145;641;-830.0;52486174
2022-02-16;513;1428;15785;468.0;52486687
2022-02-16;62;215;1702;-451.0;52486749
2022-02-16;4788;13253;78112;4726.0;52491537
2022-02-16;43;96;552;-4745.0;52491580
2022-02-17;146;284;11;103.0;52491726
2022-02-17;452;810;4103;306.0;52492178
2022-02-17;497;969;9964;45.0;52492675
2022-02-17;1;2;2;-496.0;52492676
2022-02-17;2839;6663;49796;2838.0;52495515
2022-02-17;58;150;990;-2781.0;52495573
2022-02-17;28;99;489;-30.0;52495601
2022-02-17;324;605;5972;296.0;52495925
2022-02-17;219;750;6084;-105.0;52496144
2022-02-17;69;206;1301;-150.0;52496213
2022-02-17;468;1211;10127;399.0;52496681
2022-02-17;53;178;665;-415.0;52496734
2022-02-17;94;273;2035;41.0;52496828
2022-02-17;329;916;8050;235.0;52497157
2022-02-17;101;210;3;-228.0;52497258
2022-02-18;178;398;6;77.0;52497436
2022-02-18;4;3;5;-174.0;52497440
2022-02-18;607;1430;6680;603.0;52498047
2022-02-18;3569;9774;68888;2962.0;52501616
2022-02-18;98;349;2362;-3471.0;52501714
2022-02-18;295;1038;8507;197.0;52502009
2022-02-18;379;919;8202;84.0;52502388
2022-02-18;71;289;1542;-308.0;52502459
2022-02-18;194;458;20;123.0;52502653
2022-02-18;566;1728;13973;372.0;52503219
2022-02-18;59;179;799;-507.0;52503278
2022-02-18;413;1209;11242;354.0;52503691
2022-02-18;38;226;1148;-375.0;52503729
2022-02-18;626;1439;13839;588.0;52504355
2022-02-18;41;109;563;-585.0;52504396
2022-02-19;157;584;4293;116.0;52504553
2022-02-19;381;1139;8219;224.0;52504934
2022-02-19;18;78;273;-363.0;52504952
2022-02-19;343;1139;3;325.0;52505295
2022-02-19;260;782;6458;-83.0;52505555
2022-02-19;17;73;449;-243.0;52505572
2022-02-19;45;173;1006;28.0;52505617
2022-02-19;272;636;5317;227.0;52505889
2022-02-19;2;3;2;-270.0;52505891
2022-02-19;470;1376;5978;468.0;52506361
2022-02-19;35;99;587;-435.0;52506396
2022-02-19;361;1218;13;326.0;52506757
2022-02-19;381;968;9302;20.0;52507138
2022-02-19;2761;8319;42122;2380.0;52509899
2022-02-19;19;51;222;-2742.0;52509918
2022-02-20;7;20;77;-12.0;52509925
2022-02-20;55;258;0;48.0;52509980
2022-02-20;69;247;1;14.0;52510049
2022-02-20;3;8;28;-66.0;52510052
2022-02-20;6;7;41;3.0;52510058
2022-02-20;76;156;1101;70.0;52510134
2022-02-20;1;0;1;-75.0;52510135
2022-02-20;92;207;894;91.0;52510227
2022-02-20;627;1531;7516;535.0;52510854
2022-02-20;7;23;176;-620.0;52510861
2022-02-20;3;11;55;-4.0;52510864
2022-02-20;107;195;1695;104.0;52510971
2022-02-20;108;204;1690;1.0;52511079
2022-02-20;29;81;668;-79.0;52511108
2022-02-20;64;114;1089;35.0;52511172
2022-02-21;239;634;5488;175.0;52511411
2022-02-21;26;58;273;-213.0;52511437
2022-02-21;171;473;3611;145.0;52511608
2022-02-21;2062;5171;35393;1891.0;52513670
2022-02-21;353;937;7325;-1709.0;52514023
2022-02-21;257;603;4527;-96.0;52514280
2022-02-21;31;92;393;-226.0;52514311
2022-02-21;52;186;3;21.0;52514363
2022-02-21;63;171;1164;11.0;52514426
2022-02-21;36;147;779;-27.0;52514462
2022-02-21;28;110;603;-8.0;52514490
2022-02-21;0;2;1;-28.0;52514490
2022-02-21;357;779;3556;357.0;52514847
2022-02-21;65;181;15;-292.0;52514912
2022-02-21;384;798;7655;319.0;52515296
2022-02-22;23;85;358;-361.0;52515319
2022-02-22;51;200;1056;28.0;52515370
2022-02-22;394;865;6527;343.0;52515764
2022-02-22;419;1082;6842;25.0;52516183
2022-02-22;29;131;527;-390.0;52516212
2022-02-22;78;184;11;49.0;52516290
2022-02-22;39;140;782;-39.0;52516329
2022-02-22;281;566;3950;242.0;52516610
2022-02-22;56;156;4;-225.0;52516666
2022-02-22;261;766;5326;205.0;52516927
2022-02-22;2224;5776;33648;1963.0;52519151
2022-02-22;65;245;1412;-2159.0;52519216
2022-02-22;343;743;2857;278.0;52519559
2022-02-22;183;609;3992;-160.0;52519742
2022-02-22;2;4;4;-181.0;52519744
2022-02-23;20;71;379;18.0;52519764
2022-02-23;35;102;446;15.0;52519799
2022-02-23;51;215;1211;16.0;52519850
2022-02-23;412;1142;7120;361.0;52520262
2022-02-23;30;102;693;-382.0;52520292
2022-02-23;435;1819;4;405.0;52520727
2022-02-23;3393;10122;37693;2958.0;52524120
2022-02-23;582;2047;16;-2811.0;52524702
2022-02-23;541;1451;5198;-41.0;52525243
2022-02-23;494;1007;8201;-47.0;52525737
2022-02-23;223;700;5324;-271.0;52525960
2022-02-23;2;6;1;-221.0;52525962
2022-02-23;179;582;3661;177.0;52526141
2022-02-23;52;173;837;-127.0;52526193
2022-02-23;337;705;4602;285.0;52526530
2022-02-24;35;122;662;-302.0;52526565
2022-02-24;42;155;813;7.0;52526607
2022-02-24;3;3;2;-39.0;52526610
2022-02-24;285;615;2372;282.0;52526895
2022-02-24;15;67;343;-270.0;52526910
2022-02-24;30;113;482;15.0;52526940
2022-02-24;377;728;5549;347.0;52527317
2022-02-24;221;711;4362;-156.0;52527538
2022-02-24;158;542;3250;-63.0;52527696
2022-02-24;232;500;3328;74.0;52527928
2022-02-24;374;913;5677;142.0;52528302
2022-02-24;1927;4932;27932;1553.0;52530229
2022-02-24;62;142;10;-1865.0;52530291
2022-02-24;45;214;1081;-17.0;52530336
2022-02-24;48;107;1;3.0;52530384
2022-02-25;484;1170;4478;436.0;52530868
2022-02-25;219;842;4823;-265.0;52531087
2022-02-25;62;282;1524;-157.0;52531149
2022-02-25;494;1549;8433;432.0;52531643
2022-02-25;48;191;1057;-446.0;52531691
2022-02-25;115;335;10;67.0;52531806
2022-02-25;68;258;2;-47.0;52531874
2022-02-25;301;1029;6667;233.0;52532175
2022-02-25;35;162;606;-266.0;52532210
2022-02-25;55;147;871;20.0;52532265
2022-02-25;1;4;2;-54.0;52532266
2022-02-25;26;92;392;25.0;52532292
2022-02-25;293;860;5025;267.0;52532585
2022-02-25;2684;8067;42502;2391.0;52535269
2022-02-25;483;1146;8612;-2201.0;52535752
2022-02-26;233;801;0;-250.0;52535985
2022-02-26;255;912;10;22.0;52536240
2022-02-26;293;869;5264;38.0;52536533
2022-02-26;17;40;150;-276.0;52536550
2022-02-26;21;69;376;4.0;52536571
2022-02-26;111;395;2539;90.0;52536682
2022-02-26;2008;6287;27717;1897.0;52538690
2022-02-26;161;598;4190;-1847.0;52538851
2022-02-26;198;512;3370;37.0;52539049
2022-02-26;38;113;680;-160.0;52539087
2022-02-26;2;1;1;-36.0;52539089
2022-02-26;285;795;6036;283.0;52539374
2022-02-26;14;54;327;-271.0;52539388
2022-02-26;12;58;199;-2.0;52539400
2022-02-26;368;1070;4575;356.0;52539768
2022-02-27;83;164;1042;-285.0;52539851
2022-02-27;59;117;756;-24.0;52539910
2022-02-27;31;63;358;-28.0;52539941
2022-02-27;4;7;11;-27.0;52539945
2022-02-27;3;11;30;-1.0;52539948
2022-02-27;1;2;0;-2.0;52539949
2022-02-27;7;20;99;6.0;52539956
2022-02-27;45;103;678;38.0;52540001
2022-02-27;2;9;25;-43.0;52540003
2022-02-27;454;1068;4806;452.0;52540457
2022-02-27;33;137;0;-421.0;52540490
2022-02-27;47;163;1;14.0;52540537
2022-02-27;77;133;1162;30.0;52540614
2022-02-27;4;16;54;-73.0;52540618
2022-02-27;58;123;590;54.0;52540676
2022-02-28;1541;3917;22790;1483.0;52542217
2022-02-28;0;2;2;-1541.0;52542217
2022-02-28;23;59;288;23.0;52542240
2022-02-28;129;393;2240;106.0;52542369
2022-02-28;38;131;687;-91.0;52542407
2022-02-28;10;29;207;-28.0;52542417
2022-02-28;296;649;5171;286.0;52542713
2022-02-28;27;80;432;-269.0;52542740
2022-02-28;218;457;3112;191.0;52542958
2022-02-28;289;792;4818;71.0;52543247
2022-02-28;36;130;9;-253.0;52543283
2022-02-28;249;503;1923;213.0;52543532
2022-02-28;44;116;0;-205.0;52543576
2022-02-28;23;80;526;-21.0;52543599
2022-02-28;159;496;3375;136.0;52543758
2022-03-01;368;623;4759;209.0;52544126
2022-03-01;59;159;905;-309.0;52544185
2022-03-01;2037;3855;23859;1978.0;52546222
2022-03-01;2;3;3;-2035.0;52546224
2022-03-01;25;81;553;23.0;52546249
2022-03-01;40;120;715;15.0;52546289
2022-03-01;276;408;3093;236.0;52546565
2022-03-01;143;394;2598;-133.0;52546708
2022-03-01;287;496;1770;144.0;52546995
2022-03-01;27;79;384;-260.0;52547022
2022-03-01;41;110;12;14.0;52547063
2022-03-01;42;85;2;1.0;52547105
2022-03-01;415;739;5080;373.0;52547520
2022-03-01;19;45;251;-396.0;52547539
2022-03-01;293;513;3734;274.0;52547832
2022-03-02;2660;6604;25911;2367.0;52550492
2022-03-02;259;505;3590;-2401.0;52550751
2022-03-02;356;1289;15;97.0;52551107
2022-03-02;43;98;620;-313.0;52551150
2022-03-02;32;77;542;-11.0;52551182
2022-03-02;385;770;4943;353.0;52551567
2022-03-02;435;998;3657;50.0;52552002
2022-03-02;263;1058;1;-172.0;52552265
2022-03-02;29;71;280;-234.0;52552294
2022-03-02;376;699;5547;347.0;52552670
2022-03-02;264;484;3213;-112.0;52552934
2022-03-02;3;2;3;-261.0;52552937
2022-03-02;154;366;2409;151.0;52553091
2022-03-02;48;130;838;-106.0;52553139
2022-03-02;13;57;253;-35.0;52553152
2022-03-03;262;569;3230;249.0;52553414
2022-03-03;16;44;204;-246.0;52553430
2022-03-03;1405;3064;15520;1389.0;52554835
2022-03-03;29;59;3;-1376.0;52554864
2022-03-03;213;413;1163;184.0;52555077
2022-03-03;23;62;371;-190.0;52555100
2022-03-03;173;348;1902;150.0;52555273
2022-03-03;157;398;2525;-16.0;52555430
2022-03-03;31;93;483;-126.0;52555461
2022-03-03;34;128;600;3.0;52555495
2022-03-03;2;1;0;-32.0;52555497
2022-03-03;101;324;1703;99.0;52555598
2022-03-03;49;90;11;-52.0;52555647
2022-03-03;293;457;3067;244.0;52555940
2022-03-03;22;78;258;-271.0;52555962
2022-03-04;1620;4274;20405;1598.0;52557582
2022-03-04;267;630;3463;-1353.0;52557849
2022-03-04;57;124;7;-210.0;52557906
2022-03-04;176;440;2252;119.0;52558082
2022-03-04;35;83;362;-141.0;52558117
2022-03-04;22;52;285;-13.0;52558139
2022-03-04;298;758;3897;276.0;52558437
2022-03-04;135;416;2357;-163.0;52558572
2022-03-04;38;83;546;-97.0;52558610
2022-03-04;34;127;671;-4.0;52558644
2022-03-04;2;1;2;-32.0;52558646
2022-03-04;57;180;13;55.0;52558703
2022-03-04;44;148;818;-13.0;52558747
2022-03-04;205;576;3320;161.0;52558952
2022-03-04;250;656;2412;45.0;52559202
2022-03-05;125;230;1432;-125.0;52559327
2022-03-05;1;2;0;-124.0;52559328
2022-03-05;195;397;2211;194.0;52559523
2022-03-05;1584;3698;13142;1389.0;52561107
2022-03-05;162;565;5;-1422.0;52561269
2022-03-05;44;59;387;-118.0;52561313
2022-03-05;137;256;1427;93.0;52561450
2022-03-05;192;626;8;55.0;52561642
2022-03-05;11;22;112;-181.0;52561653
2022-03-05;259;472;2255;248.0;52561912
2022-03-05;177;349;1995;-82.0;52562089
2022-03-05;17;48;219;-160.0;52562106
2022-03-05;231;588;2676;214.0;52562337
2022-03-05;25;48;279;-206.0;52562362
2022-03-05;8;36;136;-17.0;52562370
2022-03-06;28;84;2;20.0;52562398
2022-03-06;1;3;25;-27.0;52562399
2022-03-06;10;8;35;9.0;52562409
2022-03-06;27;64;259;17.0;52562436
2022-03-06;3;6;20;-24.0;52562439
2022-03-06;271;549;1835;268.0;52562710
2022-03-06;18;37;181;-253.0;52562728
2022-03-06;28;56;308;10.0;52562756
2022-03-06;34;67;313;6.0;52562790
2022-03-06;0;0;0;-34.0;52562790
2022-03-06;35;81;0;35.0;52562825
2022-03-06;37;50;225;2.0;52562862
2022-03-06;1;3;30;-36.0;52562863
2022-03-06;4;5;21;3.0;52562867
2022-03-06;45;85;416;41.0;52562912
2022-03-07;125;206;593;80.0;52563037
2022-03-07;166;247;1538;41.0;52563203
2022-03-07;27;37;256;-139.0;52563230
2022-03-07;18;37;163;-9.0;52563248
2022-03-07;15;42;142;-3.0;52563263
2022-03-07;1231;1868;9009;1216.0;52564494
2022-03-07;1;0;1;-1230.0;52564495
2022-03-07;41;75;398;40.0;52564536
2022-03-07;257;361;1926;216.0;52564793
2022-03-07;211;262;1442;-46.0;52565004
2022-03-07;155;196;1153;-56.0;52565159
2022-03-07;27;68;3;-128.0;52565186
2022-03-07;124;190;1107;97.0;52565310
2022-03-07;36;64;281;-88.0;52565346
2022-03-07;28;83;6;-8.0;52565374
2022-03-08;1046;2169;8956;1018.0;52566420
2022-03-08;50;101;483;-996.0;52566470
2022-03-08;143;290;1219;93.0;52566613
2022-03-08;29;79;227;-114.0;52566642
2022-03-08;120;277;618;91.0;52566762
2022-03-08;23;51;3;-97.0;52566785
2022-03-08;31;84;403;8.0;52566816
2022-03-08;25;61;349;-6.0;52566841
2022-03-08;0;1;1;-25.0;52566841
2022-03-08;12;29;1;12.0;52566853
2022-03-08;112;210;963;100.0;52566965
2022-03-08;16;43;165;-96.0;52566981
2022-03-08;222;383;1761;206.0;52567203
2022-03-08;125;257;1207;-97.0;52567328
2022-03-08;138;303;1556;13.0;52567466
2022-03-09;2;3;0;-136.0;52567468
2022-03-09;267;931;21;265.0;52567735
2022-03-09;169;237;1268;-98.0;52567904
2022-03-09;211;837;6;42.0;52568115
2022-03-09;27;56;221;-184.0;52568142
2022-03-09;23;33;169;-4.0;52568165
2022-03-09;164;350;1461;141.0;52568329
2022-03-09;241;720;1710;77.0;52568570
2022-03-09;51;91;375;-190.0;52568621
2022-03-09;179;295;1619;128.0;52568800
2022-03-09;119;304;996;-60.0;52568919
2022-03-09;36;51;323;-83.0;52568955
2022-03-09;1785;4445;10505;1749.0;52570740
2022-03-09;64;86;504;-1721.0;52570804
2022-03-09;232;451;1832;168.0;52571036
2022-03-10;169;392;1612;-63.0;52571205
2022-03-10;107;215;1046;-62.0;52571312
2022-03-10;112;299;1328;5.0;52571424
2022-03-10;27;44;1;-85.0;52571451
2022-03-10;132;301;1064;105.0;52571583
2022-03-10;96;241;512;-36.0;52571679
2022-03-10;27;63;339;-69.0;52571706
2022-03-10;0;0;3;-27.0;52571706
2022-03-10;39;83;448;39.0;52571745
2022-03-10;909;2131;7879;870.0;52572654
2022-03-10;32;59;280;-877.0;52572686
2022-03-10;108;237;852;76.0;52572794
2022-03-10;22;100;6;-86.0;52572816
2022-03-10;20;65;221;-2.0;52572836
2022-03-10;18;32;167;-2.0;52572854
2022-03-11;43;139;6;25.0;52572897
2022-03-11;210;441;1955;167.0;52573107
2022-03-11;32;108;1;-178.0;52573139
2022-03-11;0;0;0;-32.0;52573139
2022-03-11;43;64;484;43.0;52573182
2022-03-11;39;54;348;-4.0;52573221
2022-03-11;17;47;195;-22.0;52573238
2022-03-11;106;229;990;89.0;52573344
2022-03-11;150;342;1750;44.0;52573494
2022-03-11;140;309;1271;-10.0;52573634
2022-03-11;32;54;265;-108.0;52573666
2022-03-11;98;268;1587;66.0;52573764
2022-03-11;1153;2622;10627;1055.0;52574917
2022-03-11;190;470;1197;-963.0;52575107
2022-03-11;53;97;578;-137.0;52575160
2022-03-12;15;16;97;-38.0;52575175
2022-03-12;172;297;1403;157.0;52575347
2022-03-12;163;516;0;-9.0;52575510
2022-03-12;112;151;989;-51.0;52575622
2022-03-12;228;523;15;116.0;52575850
2022-03-12;37;35;314;-191.0;52575887
2022-03-12;2;1;1;-35.0;52575889
2022-03-12;11;26;187;9.0;52575900
2022-03-12;12;29;96;1.0;52575912
2022-03-12;166;517;1842;154.0;52576078
2022-03-12;90;161;709;-76.0;52576168
2022-03-12;118;201;990;28.0;52576286
2022-03-12;156;210;1217;38.0;52576442
2022-03-12;1305;2732;8088;1149.0;52577747
2022-03-12;23;49;228;-1282.0;52577770
2022-03-13;4;4;16;-19.0;52577774
2022-03-13;28;37;140;24.0;52577802
2022-03-13;23;45;2;-5.0;52577825
2022-03-13;26;43;181;3.0;52577851
2022-03-13;14;35;2;-12.0;52577865
2022-03-13;30;31;197;16.0;52577895
2022-03-13;20;21;123;-10.0;52577915
2022-03-13;207;320;1133;187.0;52578122
2022-03-13;1;4;14;-206.0;52578123
2022-03-13;1;1;0;0.0;52578124
2022-03-13;1;3;8;0.0;52578125
2022-03-13;2;10;46;1.0;52578127
2022-03-13;4;4;23;2.0;52578131
2022-03-13;36;50;259;32.0;52578167
2022-03-13;17;32;122;-19.0;52578184
2022-03-14;14;41;0;-3.0;52578198
2022-03-14;20;36;319;6.0;52578218
2022-03-14;17;34;254;-3.0;52578235
2022-03-14;14;26;225;-3.0;52578249
2022-03-14;732;1347;6824;718.0;52578981
2022-03-14;132;250;1382;-600.0;52579113
2022-03-14;98;204;519;-34.0;52579211
2022-03-14;7;21;139;-91.0;52579218
2022-03-14;0;0;0;-7.0;52579218
2022-03-14;86;152;857;86.0;52579304
2022-03-14;105;173;1146;19.0;52579409
2022-03-14;87;139;740;-18.0;52579496
2022-03-14;23;49;1;-64.0;52579519
2022-03-14;28;53;384;5.0;52579547
2022-03-14;101;169;858;73.0;52579648
2022-03-15;105;375;716;4.0;52579753
2022-03-15;79;286;634;-26.0;52579832
2022-03-15;143;526;1295;64.0;52579975
2022-03-15;31;40;324;-112.0;52580006
2022-03-15;102;318;490;71.0;52580108
2022-03-15;22;49;305;-80.0;52580130
2022-03-15;19;33;3;-3.0;52580149
2022-03-15;38;72;347;19.0;52580187
2022-03-15;1;1;2;-37.0;52580188
2022-03-15;120;373;1157;119.0;52580308
2022-03-15;36;89;453;-84.0;52580344
2022-03-15;21;29;175;-15.0;52580365
2022-03-15;90;256;1017;69.0;52580455
2022-03-15;21;71;6;-69.0;52580476
2022-03-15;828;2518;6924;807.0;52581304
2022-03-16;134;224;1325;-694.0;52581438
2022-03-16;111;253;874;-23.0;52581549
2022-03-16;194;502;8;83.0;52581743
2022-03-16;21;30;374;-173.0;52581764
2022-03-16;175;290;1545;154.0;52581939
2022-03-16;97;179;1040;-78.0;52582036
2022-03-16;1497;3041;8660;1400.0;52583533
2022-03-16;107;213;747;-1390.0;52583640
2022-03-16;252;525;1352;145.0;52583892
2022-03-16;25;34;298;-227.0;52583917
2022-03-16;44;67;511;19.0;52583961
2022-03-16;41;45;380;-3.0;52584002
2022-03-16;282;652;19;241.0;52584284
2022-03-16;0;0;0;-282.0;52584284
2022-03-16;14;27;187;14.0;52584298
2022-03-17;69;146;524;55.0;52584367
2022-03-17;131;277;1000;62.0;52584498
2022-03-17;19;39;3;-112.0;52584517
2022-03-17;95;205;977;76.0;52584612
2022-03-17;24;46;335;-71.0;52584636
2022-03-17;78;159;614;54.0;52584714
2022-03-17;21;51;11;-57.0;52584735
2022-03-17;71;141;792;50.0;52584806
2022-03-17;0;0;0;-71.0;52584806
2022-03-17;16;28;154;16.0;52584822
2022-03-17;99;178;481;83.0;52584921
2022-03-17;18;39;311;-81.0;52584939
2022-03-17;11;40;253;-7.0;52584950
2022-03-17;675;1386;5689;664.0;52585625
2022-03-17;23;37;234;-652.0;52585648
2022-03-18;29;48;525;6.0;52585677
2022-03-18;0;1;1;-29.0;52585677
2022-03-18;89;168;656;89.0;52585766
2022-03-18;171;342;1321;82.0;52585937
2022-03-18;32;99;1;-139.0;52585969
2022-03-18;39;67;473;7.0;52586008
2022-03-18;141;248;1412;102.0;52586149
2022-03-18;23;34;354;-118.0;52586172
2022-03-18;1072;2036;8424;1049.0;52587244
2022-03-18;116;242;808;-956.0;52587360
2022-03-18;205;367;992;89.0;52587565
2022-03-18;37;59;404;-168.0;52587602
2022-03-18;103;202;1240;66.0;52587705
2022-03-18;19;21;233;-84.0;52587724
2022-03-18;68;138;4;49.0;52587792
2022-03-19;59;118;430;-9.0;52587851
2022-03-19;20;20;155;-39.0;52587871
2022-03-19;171;379;6;151.0;52588042
2022-03-19;11;15;246;-160.0;52588053
2022-03-19;22;47;233;11.0;52588075
2022-03-19;192;444;8;170.0;52588267
2022-03-19;122;174;903;-70.0;52588389
2022-03-19;1083;2042;5885;961.0;52589472
2022-03-19;20;26;175;-1063.0;52589492
2022-03-19;71;157;611;51.0;52589563
2022-03-19;13;16;130;-58.0;52589576
2022-03-19;168;349;1341;155.0;52589744
2022-03-19;121;187;920;-47.0;52589865
2022-03-19;0;0;0;-121.0;52589865
2022-03-19;93;110;727;93.0;52589958
2022-03-20;9;11;110;-84.0;52589967
2022-03-20;3;7;24;-6.0;52589970
2022-03-20;16;22;155;13.0;52589986
2022-03-20;44;50;153;28.0;52590030
2022-03-20;12;32;2;-32.0;52590042
2022-03-20;14;43;196;2.0;52590056
2022-03-20;4;4;27;-10.0;52590060
2022-03-20;12;39;0;8.0;52590072
2022-03-20;15;28;108;3.0;52590087
2022-03-20;10;26;96;-5.0;52590097
2022-03-20;148;274;935;138.0;52590245
2022-03-20;4;2;12;-144.0;52590249
2022-03-20;4;6;35;0.0;52590253
2022-03-20;1;2;17;-3.0;52590254
2022-03-20;0;2;0;-1.0;52590254
2022-03-21;84;152;375;84.0;52590338
2022-03-21;0;0;0;-84.0;52590338
2022-03-21;9;18;161;9.0;52590347
2022-03-21;51;101;553;42.0;52590398
2022-03-21;21;32;264;-30.0;52590419
2022-03-21;26;42;18;5.0;52590445
2022-03-21;611;1019;5708;585.0;52591056
2022-03-21;13;20;307;-598.0;52591069
2022-03-21;31;43;332;18.0;52591100
2022-03-21;15;36;4;-16.0;52591115
2022-03-21;73;137;597;58.0;52591188
2022-03-21;58;103;717;-15.0;52591246
2022-03-21;86;137;984;28.0;52591332
2022-03-21;129;178;1161;43.0;52591461
2022-03-21;15;20;235;-114.0;52591476
2022-03-22;7;32;4;-8.0;52591483
2022-03-22;74;147;528;67.0;52591557
2022-03-22;9;13;190;-65.0;52591566
2022-03-22;28;30;301;19.0;52591594
2022-03-22;1;1;0;-27.0;52591595
2022-03-22;118;176;380;117.0;52591713
2022-03-22;139;230;1020;21.0;52591852
2022-03-22;65;147;487;-74.0;52591917
2022-03-22;126;189;946;61.0;52592043
2022-03-22;71;125;803;-55.0;52592114
2022-03-22;26;54;376;-45.0;52592140
2022-03-22;23;41;330;-3.0;52592163
2022-03-22;732;1282;5878;709.0;52592895
2022-03-22;21;47;5;-711.0;52592916
2022-03-22;24;50;508;3.0;52592940
2022-03-23;90;166;788;66.0;52593030
2022-03-23;117;193;1296;27.0;52593147
2022-03-23;0;2;0;-117.0;52593147
2022-03-23;1319;2547;8268;1319.0;52594466
2022-03-23;180;457;15;-1139.0;52594646
2022-03-23;90;166;1006;-90.0;52594736
2022-03-23;30;49;440;-60.0;52594766
2022-03-23;240;521;11;210.0;52595006
2022-03-23;14;21;217;-226.0;52595020
2022-03-23;25;34;492;11.0;52595045
2022-03-23;94;194;824;69.0;52595139
2022-03-23;223;417;1080;129.0;52595362
2022-03-23;28;38;332;-195.0;52595390
2022-03-23;164;263;1455;136.0;52595554
2022-03-23;24;26;312;-140.0;52595578
2022-03-24;117;194;908;93.0;52595695
2022-03-24;28;33;436;-89.0;52595723
2022-03-24;16;29;229;-12.0;52595739
2022-03-24;15;38;291;-1.0;52595754
2022-03-24;89;128;690;74.0;52595843
2022-03-24;78;155;501;-11.0;52595921
2022-03-24;19;32;5;-59.0;52595940
2022-03-24;50;100;401;31.0;52595990
2022-03-24;91;160;813;41.0;52596081
2022-03-24;15;18;184;-76.0;52596096
2022-03-24;21;39;7;6.0;52596117
2022-03-24;32;26;251;11.0;52596149
2022-03-24;650;1098;5091;618.0;52596799
2022-03-24;78;146;374;-572.0;52596877
2022-03-24;1;0;1;-77.0;52596878
2022-03-25;30;35;542;29.0;52596908
2022-03-25;80;193;643;50.0;52596988
2022-03-25;22;28;222;-58.0;52597010
2022-03-25;141;301;832;119.0;52597151
2022-03-25;33;51;329;-108.0;52597184
2022-03-25;87;162;1166;54.0;52597271
2022-03-25;129;203;1317;42.0;52597400
2022-03-25;74;152;579;-55.0;52597474
2022-03-25;2;3;3;-72.0;52597476
2022-03-25;56;107;2;54.0;52597532
2022-03-25;964;1773;7768;908.0;52598496
2022-03-25;170;292;1279;-794.0;52598666
2022-03-25;28;52;367;-142.0;52598694
2022-03-25;62;122;8;34.0;52598756
2022-03-25;50;72;479;-12.0;52598806
2022-03-26;121;210;872;71.0;52598927
2022-03-26;21;47;237;-100.0;52598948
2022-03-26;160;295;3;139.0;52599108
2022-03-26;206;393;12;46.0;52599314
2022-03-26;183;320;1153;-23.0;52599497
2022-03-26;85;151;865;-98.0;52599582
2022-03-26;59;113;416;-26.0;52599641
2022-03-26;13;16;215;-46.0;52599654
2022-03-26;24;29;176;11.0;52599678
2022-03-26;16;16;154;-8.0;52599694
2022-03-26;1023;1888;5459;1007.0;52600717
2022-03-26;76;146;550;-947.0;52600793
2022-03-26;50;138;704;-26.0;52600843
2022-03-26;9;14;101;-41.0;52600852
2022-03-26;0;0;1;-9.0;52600852
2022-03-27;2;2;28;2.0;52600854
2022-03-27;18;14;116;16.0;52600872
2022-03-27;23;37;183;5.0;52600895
2022-03-27;0;0;12;-23.0;52600895
2022-03-27;32;48;143;32.0;52600927
2022-03-27;3;8;34;-29.0;52600930
2022-03-27;1;0;0;-2.0;52600931
2022-03-27;22;47;1;21.0;52600953
2022-03-27;18;22;2;-4.0;52600971
2022-03-27;4;5;14;-14.0;52600975
2022-03-27;170;248;916;166.0;52601145
2022-03-27;21;26;177;-149.0;52601166
2022-03-27;18;24;102;-3.0;52601184
2022-03-27;3;4;21;-15.0;52601187
2022-03-27;5;11;83;2.0;52601192
2022-03-28;22;30;327;17.0;52601214
2022-03-28;21;28;245;-1.0;52601235
2022-03-28;55;76;492;34.0;52601290
2022-03-28;23;38;292;-32.0;52601313
2022-03-28;89;118;347;66.0;52601402
2022-03-28;14;15;140;-75.0;52601416
2022-03-28;118;187;906;104.0;52601534
2022-03-28;32;44;1;-86.0;52601566
2022-03-28;19;24;196;-13.0;52601585
2022-03-28;62;101;648;43.0;52601647
2022-03-28;1;0;1;-61.0;52601648
2022-03-28;91;138;812;90.0;52601739
2022-03-28;76;98;460;-15.0;52601815
2022-03-28;18;34;2;-58.0;52601833
2022-03-28;641;931;4869;623.0;52602474
2022-03-29;9;17;221;-632.0;52602483
2022-03-29;85;122;870;76.0;52602568
2022-03-29;83;127;354;-2.0;52602651
2022-03-29;1;1;0;-82.0;52602652
2022-03-29;75;98;450;74.0;52602727
2022-03-29;14;33;4;-61.0;52602741
2022-03-29;634;983;5454;620.0;52603375
2022-03-29;31;36;336;-603.0;52603406
2022-03-29;96;185;941;65.0;52603502
2022-03-29;32;49;325;-64.0;52603534
2022-03-29;24;28;532;-8.0;52603558
2022-03-29;78;107;474;54.0;52603636
2022-03-29;20;34;244;-58.0;52603656
2022-03-29;69;110;697;49.0;52603725
2022-03-29;17;36;6;-52.0;52603742
2022-03-30;109;174;861;92.0;52603851
2022-03-30;2;0;1;-107.0;52603853
2022-03-30;103;152;674;101.0;52603956
2022-03-30;163;363;6;60.0;52604119
2022-03-30;248;498;13;85.0;52604367
2022-03-30;32;55;265;-216.0;52604399
2022-03-30;24;33;498;-8.0;52604423
2022-03-30;88;120;539;64.0;52604511
2022-03-30;37;59;312;-51.0;52604548
2022-03-30;1350;2332;6846;1313.0;52605898
2022-03-30;122;186;1076;-1228.0;52606020
2022-03-30;37;73;368;-85.0;52606057
2022-03-30;18;31;215;-19.0;52606075
2022-03-30;145;259;1122;127.0;52606220
2022-03-30;222;329;896;77.0;52606442
2022-03-31;723;1189;5429;501.0;52607165
2022-03-31;98;167;896;-625.0;52607263
2022-03-31;20;30;0;-78.0;52607283
2022-03-31;110;239;940;90.0;52607393
2022-03-31;88;157;488;-22.0;52607481
2022-03-31;35;48;342;-53.0;52607516
2022-03-31;31;40;278;-4.0;52607547
2022-03-31;99;141;375;68.0;52607646
2022-03-31;33;27;481;-66.0;52607679
2022-03-31;0;0;0;-33.0;52607679
2022-03-31;76;122;755;76.0;52607755
2022-03-31;64;120;451;-12.0;52607819
2022-03-31;17;18;184;-47.0;52607836
2022-03-31;35;53;5;18.0;52607871
2022-03-31;17;27;234;-18.0;52607888
2022-04-01;238;260;1785;221.0;52608126
2022-04-01;47;57;15;-191.0;52608173
2022-04-01;176;196;1494;129.0;52608349
2022-04-01;168;190;671;-8.0;52608517
2022-04-01;27;26;380;-141.0;52608544
2022-04-01;138;120;828;111.0;52608682
2022-04-01;31;34;289;-107.0;52608713
2022-04-01;26;44;572;-5.0;52608739
2022-04-01;28;39;6;2.0;52608767
2022-04-01;144;169;878;116.0;52608911
2022-04-01;1;1;1;-143.0;52608912
2022-04-01;49;65;475;48.0;52608961
2022-04-01;20;20;234;-29.0;52608981
2022-04-01;1212;1365;8823;1192.0;52610193
2022-04-01;119;144;1195;-1093.0;52610312
2022-04-02;11;19;116;-108.0;52610323
2022-04-02;694;963;3954;683.0;52611017
2022-04-02;73;132;3;-621.0;52611090
2022-04-02;6;8;90;-67.0;52611096
2022-04-02;95;110;697;89.0;52611191
2022-04-02;47;64;334;-48.0;52611238
2022-04-02;131;153;682;84.0;52611369
2022-04-02;61;75;417;-70.0;52611430
2022-04-02;63;74;530;2.0;52611493
2022-04-02;14;14;187;-49.0;52611507
2022-04-02;0;0;0;-14.0;52611507
2022-04-02;13;16;98;13.0;52611520
2022-04-02;20;24;168;7.0;52611540
2022-04-02;97;169;9;77.0;52611637
2022-04-02;63;105;623;-34.0;52611700
2022-04-03;6;6;30;-57.0;52611706
2022-04-03;135;167;744;129.0;52611841
2022-04-03;10;10;76;-125.0;52611851
2022-04-03;0;1;22;-10.0;52611851
2022-04-03;1;1;12;1.0;52611852
2022-04-03;1;3;31;0.0;52611853
2022-04-03;3;2;21;2.0;52611856
2022-04-03;13;27;0;10.0;52611869
2022-04-03;10;16;87;-3.0;52611879
2022-04-03;12;9;85;2.0;52611891
2022-04-03;0;0;0;-12.0;52611891
2022-04-03;23;24;146;23.0;52611914
2022-04-03;21;19;101;-2.0;52611935
2022-04-03;16;25;2;-5.0;52611951
2022-04-03;19;24;131;3.0;52611970
2022-04-04;43;30;248;24.0;52612013
2022-04-04;24;25;350;-19.0;52612037
2022-04-04;548;217;1054;524.0;52612585
2022-04-04;381;116;581;-167.0;52612966
2022-04-04;40;26;222;-341.0;52613006
2022-04-04;179;94;638;139.0;52613185
2022-04-04;178;130;337;-1.0;52613363
2022-04-04;2;1;1;-176.0;52613365
2022-04-04;23;21;5;21.0;52613388
2022-04-04;25;24;176;2.0;52613413
2022-04-04;450;115;605;425.0;52613863
2022-04-04;2238;1006;5317;1788.0;52616101
2022-04-04;24;15;130;-2214.0;52616125
2022-04-04;289;153;957;265.0;52616414
2022-04-04;32;39;13;-257.0;52616446
2022-04-05;238;147;1027;206.0;52616684
2022-04-05;27;41;598;-211.0;52616711
2022-04-05;132;126;938;105.0;52616843
2022-04-05;2;0;0;-130.0;52616845
2022-04-05;1143;946;5923;1141.0;52617988
2022-04-05;23;30;5;-1120.0;52618011
2022-04-05;124;113;831;101.0;52618135
2022-04-05;49;46;352;-75.0;52618184
2022-04-05;16;19;0;-33.0;52618200
2022-04-05;39;37;311;23.0;52618239
2022-04-05;20;26;204;-19.0;52618259
2022-04-05;116;127;363;96.0;52618375
2022-04-05;177;114;517;61.0;52618552
2022-04-05;158;96;496;-19.0;52618710
2022-04-05;22;24;281;-136.0;52618732
2022-04-06;26;27;254;4.0;52618758
2022-04-06;97;121;726;71.0;52618855
2022-04-06;2;1;1;-95.0;52618857
2022-04-06;99;179;5;97.0;52618956
2022-04-06;41;36;505;-58.0;52618997
2022-04-06;118;85;483;77.0;52619115
2022-04-06;126;139;908;8.0;52619241
2022-04-06;189;229;602;63.0;52619430
2022-04-06;140;221;13;-49.0;52619570
2022-04-06;132;119;553;-8.0;52619702
2022-04-06;176;193;929;44.0;52619878
2022-04-06;16;16;184;-160.0;52619894
2022-04-06;1226;1431;5710;1210.0;52621120
2022-04-06;41;41;313;-1185.0;52621161
2022-04-06;23;24;234;-18.0;52621184
2022-04-07;0;0;1;-23.0;52621184
2022-04-07;135;132;939;135.0;52621319
2022-04-07;45;46;366;-90.0;52621364
2022-04-07;92;86;728;47.0;52621456
2022-04-07;24;26;307;-68.0;52621480
2022-04-07;16;24;224;-8.0;52621496
2022-04-07;25;35;599;9.0;52621521
2022-04-07;103;93;458;78.0;52621624
2022-04-07;84;101;322;-19.0;52621708
2022-04-07;21;39;10;-63.0;52621729
2022-04-07;193;166;925;172.0;52621922
2022-04-07;18;30;274;-175.0;52621940
2022-04-07;908;906;5679;890.0;52622848
2022-04-07;135;104;523;-773.0;52622983
2022-04-07;17;24;3;-118.0;52623000
2022-04-08;41;56;8;24.0;52623041
2022-04-08;33;38;716;-8.0;52623074
2022-04-08;102;102;622;69.0;52623176
2022-04-08;27;43;2;-75.0;52623203
2022-04-08;36;37;400;9.0;52623239
2022-04-08;1;0;1;-35.0;52623240
2022-04-08;1018;1199;8066;1017.0;52624258
2022-04-08;125;151;1294;-893.0;52624383
2022-04-08;19;17;311;-106.0;52624402
2022-04-08;32;59;536;13.0;52624434
2022-04-08;44;45;424;12.0;52624478
2022-04-08;178;183;1274;134.0;52624656
2022-04-08;159;205;686;-19.0;52624815
2022-04-08;122;141;712;-37.0;52624937
2022-04-08;99;122;1080;-23.0;52625036
2022-04-09;2;2;1;-97.0;52625038
2022-04-09;72;105;723;70.0;52625110
2022-04-09;54;70;526;-18.0;52625164
2022-04-09;50;76;520;-4.0;52625214
2022-04-09;33;55;361;-17.0;52625247
2022-04-09;11;10;196;-22.0;52625258
2022-04-09;90;147;10;79.0;52625348
2022-04-09;16;21;199;-74.0;52625364
2022-04-09;73;107;691;57.0;52625437
2022-04-09;103;146;526;30.0;52625540
2022-04-09;613;902;4114;510.0;52626153
2022-04-09;16;15;119;-597.0;52626169
2022-04-09;64;113;3;48.0;52626233
2022-04-09;13;26;136;-51.0;52626246
2022-04-09;16;9;103;3.0;52626262
2022-04-10;15;16;2;-1.0;52626277
2022-04-10;2;5;22;-13.0;52626279
2022-04-10;1;1;31;-1.0;52626280
2022-04-10;10;17;1;9.0;52626290
2022-04-10;23;56;191;13.0;52626313
2022-04-10;13;21;101;-10.0;52626326
2022-04-10;2;7;19;-11.0;52626328
2022-04-10;4;8;38;2.0;52626332
2022-04-10;12;28;102;8.0;52626344
2022-04-10;0;2;17;-12.0;52626344
2022-04-10;16;34;124;16.0;52626360
2022-04-10;135;264;909;119.0;52626495
2022-04-10;12;30;157;-123.0;52626507
2022-04-10;25;39;104;13.0;52626532
2022-04-10;0;0;0;-25.0;52626532
2022-04-11;603;734;5190;603.0;52627135
2022-04-11;14;17;188;-589.0;52627149
2022-04-11;24;32;277;10.0;52627173
2022-04-11;78;100;812;54.0;52627251
2022-04-11;87;102;346;9.0;52627338
2022-04-11;99;135;1019;12.0;52627437
2022-04-11;21;39;13;-78.0;52627458
2022-04-11;18;22;345;-3.0;52627476
2022-04-11;104;96;573;86.0;52627580
2022-04-11;6;6;192;-98.0;52627586
2022-04-11;1;1;1;-5.0;52627587
2022-04-11;15;28;235;14.0;52627602
2022-04-11;12;17;7;-3.0;52627614
2022-04-11;62;62;592;50.0;52627676
2022-04-11;62;77;590;0.0;52627738
2022-04-12;2;1;1;-60.0;52627740
2022-04-12;103;125;817;101.0;52627843
2022-04-12;145;170;946;42.0;52627988
2022-04-12;39;44;354;-106.0;52628027
2022-04-12;13;26;3;-26.0;52628040
2022-04-12;30;34;302;17.0;52628070
2022-04-12;91;108;415;61.0;52628161
2022-04-12;79;92;488;-12.0;52628240
2022-04-12;90;96;571;11.0;52628330
2022-04-12;30;24;591;-60.0;52628360
2022-04-12;790;889;5850;760.0;52629150
2022-04-12;33;32;335;-757.0;52629183
2022-04-12;93;100;747;60.0;52629276
2022-04-12;24;24;2;-69.0;52629300
2022-04-12;18;13;278;-6.0;52629318
2022-04-13;35;35;478;17.0;52629353
2022-04-13;123;197;11;88.0;52629476
2022-04-13;137;179;1047;14.0;52629613
2022-04-13;73;106;711;-64.0;52629686
2022-04-13;74;107;548;1.0;52629760
2022-04-13;92;110;577;18.0;52629852
2022-04-13;979;1330;5819;887.0;52630831
2022-04-13;1;1;1;-978.0;52630832
2022-04-13;102;147;846;101.0;52630934
2022-04-13;32;36;306;-70.0;52630966
2022-04-13;98;141;7;66.0;52631064
2022-04-13;27;26;271;-71.0;52631091
2022-04-13;37;31;300;10.0;52631128
2022-04-13;137;199;508;100.0;52631265
2022-04-13;11;15;208;-126.0;52631276
2022-04-14;11;23;1;0.0;52631287
2022-04-14;664;880;5746;653.0;52631951
2022-04-14;63;85;505;-601.0;52632014
2022-04-14;0;2;0;-63.0;52632014
2022-04-14;33;27;289;33.0;52632047
2022-04-14;23;29;6;-10.0;52632070
2022-04-14;130;174;921;107.0;52632200
2022-04-14;17;14;271;-113.0;52632217
2022-04-14;77;109;384;60.0;52632294
2022-04-14;25;31;343;-52.0;52632319
2022-04-14;29;26;590;4.0;52632348
2022-04-14;21;26;297;-8.0;52632369
2022-04-14;90;118;803;69.0;52632459
2022-04-14;72;95;730;-18.0;52632531
2022-04-14;73;121;606;1.0;52632604
2022-04-15;29;30;508;-44.0;52632633
2022-04-15;816;1204;6858;787.0;52633449
2022-04-15;14;14;242;-802.0;52633463
2022-04-15;36;45;345;22.0;52633499
2022-04-15;155;253;1159;119.0;52633654
2022-04-15;29;30;352;-126.0;52633683
2022-04-15;96;162;1085;67.0;52633779
2022-04-15;126;164;562;30.0;52633905
2022-04-15;20;33;4;-106.0;52633925
2022-04-15;1;5;0;-19.0;52633926
2022-04-15;32;46;410;31.0;52633958
2022-04-15;88;140;695;56.0;52634046
2022-04-15;90;109;895;2.0;52634136
2022-04-15;73;113;592;-17.0;52634209
2022-04-15;27;60;9;-46.0;52634236
2022-04-16;483;598;2859;456.0;52634719
2022-04-16;8;10;140;-475.0;52634727
2022-04-16;4;5;69;-4.0;52634731
2022-04-16;9;13;102;5.0;52634740
2022-04-16;0;0;0;-9.0;52634740
2022-04-16;39;46;306;39.0;52634779
2022-04-16;10;12;89;-29.0;52634789
2022-04-16;68;72;494;58.0;52634857
2022-04-16;57;69;517;-11.0;52634914
2022-04-16;41;47;300;-16.0;52634955
2022-04-16;8;19;142;-33.0;52634963
2022-04-16;35;42;351;27.0;52634998
2022-04-16;34;63;2;-1.0;52635032
2022-04-16;76;101;4;42.0;52635108
2022-04-16;94;99;343;18.0;52635202
2022-04-17;6;8;54;-88.0;52635208
2022-04-17;2;2;18;-4.0;52635210
2022-04-17;15;27;75;13.0;52635225
2022-04-17;0;0;0;-15.0;52635225
2022-04-17;5;6;45;5.0;52635230
2022-04-17;4;5;11;-1.0;52635234
2022-04-17;2;3;0;-2.0;52635236
2022-04-17;3;4;17;1.0;52635239
2022-04-17;75;109;469;72.0;52635314
2022-04-17;14;19;118;-61.0;52635328
2022-04-17;1;1;14;-13.0;52635329
2022-04-17;7;13;54;6.0;52635336
2022-04-17;4;2;12;-3.0;52635340
2022-04-17;8;15;51;4.0;52635348
2022-04-17;4;4;0;-4.0;52635352
2022-04-18;1;3;21;-3.0;52635353
2022-04-18;13;26;208;12.0;52635366
2022-04-18;22;45;395;9.0;52635388
2022-04-18;4;1;29;-18.0;52635392
2022-04-18;10;14;124;6.0;52635402
2022-04-18;4;4;3;-6.0;52635406
2022-04-18;16;24;271;12.0;52635422
2022-04-18;12;22;70;-4.0;52635434
2022-04-18;12;25;221;0.0;52635446
2022-04-18;0;1;18;-12.0;52635446
2022-04-18;3;1;30;3.0;52635449
2022-04-18;0;0;0;-3.0;52635449
2022-04-18;3;5;32;3.0;52635452
2022-04-18;104;181;1428;101.0;52635556
2022-04-18;4;10;6;-100.0;52635560
2022-04-19;59;77;518;55.0;52635619
2022-04-19;27;32;6;-32.0;52635646
2022-04-19;16;19;1;-11.0;52635662
2022-04-19;27;32;411;11.0;52635689
2022-04-19;72;92;676;45.0;52635761
2022-04-19;0;0;0;-72.0;52635761
2022-04-19;27;26;288;27.0;52635788
2022-04-19;68;99;593;41.0;52635856
2022-04-19;662;825;5492;594.0;52636518
2022-04-19;101;132;415;-561.0;52636619
2022-04-19;125;136;933;24.0;52636744
2022-04-19;17;20;275;-108.0;52636761
2022-04-19;11;14;244;-6.0;52636772
2022-04-19;90;110;846;79.0;52636862
2022-04-19;22;36;286;-68.0;52636884
2022-04-20;87;115;577;65.0;52636971
2022-04-20;71;100;5;-16.0;52637042
2022-04-20;1;0;0;-70.0;52637043
2022-04-20;23;22;202;22.0;52637066
2022-04-20;27;30;318;4.0;52637093
2022-04-20;67;87;613;40.0;52637160
2022-04-20;126;134;870;59.0;52637286
2022-04-20;33;43;265;-93.0;52637319
2022-04-20;126;185;10;93.0;52637445
2022-04-20;157;201;538;31.0;52637602
2022-04-20;21;34;268;-136.0;52637623
2022-04-20;65;101;705;44.0;52637688
2022-04-20;26;29;401;-39.0;52637714
2022-04-20;129;143;1066;103.0;52637843
2022-04-20;959;1224;5838;830.0;52638802
2022-04-21;87;95;534;-872.0;52638889
2022-04-21;114;139;363;27.0;52639003
2022-04-21;75;83;781;-39.0;52639078
2022-04-21;15;18;272;-60.0;52639093
2022-04-21;680;829;5481;665.0;52639773
2022-04-21;1;1;2;-679.0;52639774
2022-04-21;3;19;3;2.0;52639777
2022-04-21;22;27;6;19.0;52639799
2022-04-21;30;33;302;8.0;52639829
2022-04-21;19;25;284;-11.0;52639848
2022-04-21;64;74;702;45.0;52639912
2022-04-21;28;41;325;-36.0;52639940
2022-04-21;28;43;540;0.0;52639968
2022-04-21;124;138;904;96.0;52640092
2022-04-21;70;93;463;-54.0;52640162
2022-04-22;68;87;663;-2.0;52640230
2022-04-22;96;142;1105;28.0;52640326
2022-04-22;41;44;431;-55.0;52640367
2022-04-22;29;45;389;-12.0;52640396
2022-04-22;38;39;346;9.0;52640434
2022-04-22;21;18;266;-17.0;52640455
2022-04-22;71;93;915;50.0;52640526
2022-04-22;23;35;5;-48.0;52640549
2022-04-22;127;181;1271;104.0;52640676
2022-04-22;0;0;1;-127.0;52640676
2022-04-22;20;24;513;20.0;52640696
2022-04-22;168;184;516;148.0;52640864
2022-04-22;96;124;730;-72.0;52640960
2022-04-22;38;52;7;-58.0;52640998
2022-04-22;836;1068;7158;798.0;52641834
2022-04-23;56;94;634;-780.0;52641890
2022-04-23;11;9;100;-45.0;52641901
2022-04-23;84;92;355;73.0;52641985
2022-04-23;49;61;377;-35.0;52642034
2022-04-23;9;9;114;-40.0;52642043
2022-04-23;41;68;5;32.0;52642084
2022-04-23;506;670;3255;465.0;52642590
2022-04-23;17;26;150;-489.0;52642607
2022-04-23;6;17;114;-11.0;52642613
2022-04-23;48;62;391;42.0;52642661
2022-04-23;1;0;0;-47.0;52642662
2022-04-23;44;48;343;43.0;52642706
2022-04-23;66;78;548;22.0;52642772
2022-04-23;8;15;110;-58.0;52642780
2022-04-23;66;91;14;58.0;52642846
2022-04-24;11;17;101;-55.0;52642857
2022-04-24;5;3;15;-6.0;52642862
2022-04-24;7;11;55;2.0;52642869
2022-04-24;2;2;16;-5.0;52642871
2022-04-24;11;17;85;9.0;52642882
2022-04-24;0;0;0;-11.0;52642882
2022-04-24;18;34;151;18.0;52642900
2022-04-24;114;146;631;96.0;52643014
2022-04-24;8;16;97;-106.0;52643022
2022-04-24;19;16;58;11.0;52643041
2022-04-24;1;2;24;-18.0;52643042
2022-04-24;11;14;1;10.0;52643053
2022-04-24;5;5;13;-6.0;52643058
2022-04-24;13;8;0;8.0;52643071
2022-04-24;3;1;15;-10.0;52643074
2022-04-25;25;27;236;22.0;52643099
2022-04-25;65;90;523;40.0;52643164
2022-04-25;16;28;0;-49.0;52643180
2022-04-25;0;0;0;-16.0;52643180
2022-04-25;24;18;220;24.0;52643204
2022-04-25;59;69;495;35.0;52643263
2022-04-25;64;74;586;5.0;52643327
2022-04-25;7;12;161;-57.0;52643334
2022-04-25;102;116;954;95.0;52643436
2022-04-25;568;679;4700;466.0;52644004
2022-04-25;19;11;220;-549.0;52644023
2022-04-25;68;88;711;49.0;52644091
2022-04-25;25;39;10;-43.0;52644116
2022-04-25;9;12;271;-16.0;52644125
2022-04-25;85;95;313;76.0;52644210
2022-04-26;109;135;935;24.0;52644319
2022-04-26;30;32;3;-79.0;52644349
2022-04-26;14;13;260;-16.0;52644363
2022-04-26;10;21;1;-4.0;52644373
2022-04-26;25;40;378;15.0;52644398
2022-04-26;0;1;0;-25.0;52644398
2022-04-26;26;30;321;26.0;52644424
2022-04-26;18;20;335;-8.0;52644442
2022-04-26;105;121;323;87.0;52644547
2022-04-26;75;88;748;-30.0;52644622
2022-04-26;678;814;5675;603.0;52645300
2022-04-26;23;27;521;-655.0;52645323
2022-04-26;94;118;812;71.0;52645417
2022-04-26;88;97;555;-6.0;52645505
2022-04-26;61;71;483;-27.0;52645566
2022-04-27;14;13;211;-47.0;52645580
2022-04-27;861;1056;4910;847.0;52646441
2022-04-27;62;95;5;-799.0;52646503
2022-04-27;114;124;789;52.0;52646617
2022-04-27;107;158;10;-7.0;52646724
2022-04-27;31;34;415;-76.0;52646755
2022-04-27;0;0;0;-31.0;52646755
2022-04-27;24;42;302;24.0;52646779
2022-04-27;71;83;603;47.0;52646850
2022-04-27;79;99;709;8.0;52646929
2022-04-27;22;28;259;-57.0;52646951
2022-04-27;58;78;464;36.0;52647009
2022-04-27;71;86;469;13.0;52647080
2022-04-27;22;35;257;-49.0;52647102
2022-04-27;186;181;417;164.0;52647288
2022-04-28;20;17;4;-166.0;52647308
2022-04-28;52;51;446;32.0;52647360
2022-04-28;133;144;910;81.0;52647493
2022-04-28;673;764;5201;540.0;52648166
2022-04-28;8;13;256;-665.0;52648174
2022-04-28;23;34;7;15.0;52648197
2022-04-28;93;116;304;70.0;52648290
2022-04-28;32;37;283;-61.0;52648322
2022-04-28;24;37;330;-8.0;52648346
2022-04-28;71;90;622;47.0;52648417
2022-04-28;26;26;276;-45.0;52648443
2022-04-28;1;2;0;-25.0;52648444
2022-04-28;84;85;528;83.0;52648528
2022-04-28;76;88;741;-8.0;52648604
2022-04-28;30;24;494;-46.0;52648634
2022-04-29;1;1;0;-29.0;52648635
2022-04-29;77;203;559;76.0;52648712
2022-04-29;168;336;1133;91.0;52648880
2022-04-29;27;27;3;-141.0;52648907
2022-04-29;48;55;13;21.0;52648955
2022-04-29;30;39;326;-18.0;52648985
2022-04-29;19;41;518;-11.0;52649004
2022-04-29;77;155;890;58.0;52649081
2022-04-29;107;222;645;30.0;52649188
2022-04-29;122;221;1031;15.0;52649310
2022-04-29;28;45;324;-94.0;52649338
2022-04-29;906;1628;6573;878.0;52650244
2022-04-29;38;59;391;-868.0;52650282
2022-04-29;153;205;461;115.0;52650435
2022-04-29;11;19;279;-142.0;52650446
2022-04-30;41;51;0;30.0;52650487
2022-04-30;7;13;126;-34.0;52650494
2022-04-30;92;480;586;85.0;52650586
2022-04-30;10;18;104;-82.0;52650596
2022-04-30;50;339;295;40.0;52650646
2022-04-30;58;408;331;8.0;52650704
2022-04-30;86;153;329;28.0;52650790
2022-04-30;55;54;10;-31.0;52650845
2022-04-30;530;1954;3073;475.0;52651375
2022-04-30;10;25;105;-520.0;52651385
2022-04-30;19;30;169;9.0;52651404
2022-04-30;9;17;72;-10.0;52651413
2022-04-30;50;217;522;41.0;52651463
2022-04-30;0;1;0;-50.0;52651463
2022-04-30;43;148;424;43.0;52651506
2022-05-01;4;3;1;-39.0;52651510
2022-05-01;5;11;38;1.0;52651515
2022-05-01;6;5;17;1.0;52651521
2022-05-01;110;113;405;104.0;52651631
2022-05-01;29;34;114;-81.0;52651660
2022-05-01;2;3;13;-27.0;52651662
2022-05-01;0;3;13;-2.0;52651662
2022-05-01;4;5;0;4.0;52651666
2022-05-01;15;13;40;11.0;52651681
2022-05-01;11;7;34;-4.0;52651692
2022-05-01;20;15;68;9.0;52651712
2022-05-01;5;3;4;-15.0;52651717
2022-05-01;0;0;0;-5.0;52651717
2022-05-01;2;2;10;2.0;52651719
2022-05-01;7;9;53;5.0;52651726
2022-05-02;15;15;237;8.0;52651741
2022-05-02;234;179;1124;219.0;52651975
2022-05-02;214;135;606;-20.0;52652189
2022-05-02;128;124;246;-86.0;52652317
2022-05-02;14;16;170;-114.0;52652331
2022-05-02;27;21;16;13.0;52652358
2022-05-02;1;2;4;-26.0;52652359
2022-05-02;35;34;263;34.0;52652394
2022-05-02;13;11;144;-22.0;52652407
2022-05-02;19;15;1;6.0;52652426
2022-05-02;23;30;191;4.0;52652449
2022-05-02;164;161;844;141.0;52652613
2022-05-02;140;105;645;-24.0;52652753
2022-05-02;1115;944;5120;975.0;52653868
2022-05-02;88;96;629;-1027.0;52653956
2022-05-03;141;144;991;53.0;52654097
2022-05-03;904;933;6073;763.0;52655001
2022-05-03;33;39;10;-871.0;52655034
2022-05-03;33;35;329;0.0;52655067
2022-05-03;26;31;349;-7.0;52655093
2022-05-03;131;91;590;105.0;52655224
2022-05-03;0;0;1;-131.0;52655224
2022-05-03;14;12;241;14.0;52655238
2022-05-03;135;124;350;121.0;52655373
2022-05-03;19;27;430;-116.0;52655392
2022-05-03;31;15;3;12.0;52655423
2022-05-03;73;79;556;42.0;52655496
2022-05-03;81;100;793;8.0;52655577
2022-05-03;30;38;381;-51.0;52655607
2022-05-03;157;198;1049;127.0;52655764
2022-05-04;14;12;189;-143.0;52655778
2022-05-04;51;71;5;37.0;52655829
2022-05-04;867;1080;5410;816.0;52656696
2022-05-04;28;37;256;-839.0;52656724
2022-05-04;104;162;929;76.0;52656828
2022-05-04;95;115;854;-9.0;52656923
2022-05-04;76;107;610;-19.0;52656999
2022-05-04;100;110;21;24.0;52657099
2022-05-04;169;193;431;69.0;52657268
2022-05-04;37;39;323;-132.0;52657305
2022-05-04;20;18;271;-17.0;52657325
2022-05-04;76;98;630;56.0;52657401
2022-05-04;26;32;341;-50.0;52657427
2022-05-04;70;84;546;44.0;52657497
2022-05-04;1;2;4;-69.0;52657498
2022-05-05;809;929;5710;808.0;52658307
2022-05-05;125;143;899;-684.0;52658432
2022-05-05;87;119;561;-38.0;52658519
2022-05-05;108;107;335;21.0;52658627
2022-05-05;30;27;335;-78.0;52658657
2022-05-05;105;103;729;75.0;52658762
2022-05-05;23;32;325;-82.0;52658785
2022-05-05;30;24;453;7.0;52658815
2022-05-05;31;26;365;1.0;52658846
2022-05-05;8;15;2;-23.0;52658854
2022-05-05;26;23;235;18.0;52658880
2022-05-05;26;20;9;0.0;52658906
2022-05-05;75;98;504;49.0;52658981
2022-05-05;134;191;957;59.0;52659115
2022-05-05;1;1;1;-133.0;52659116
2022-05-06;0;1;3;-1.0;52659116
2022-05-06;83;95;557;83.0;52659199
2022-05-06;28;39;423;-55.0;52659227
2022-05-06;37;48;6;9.0;52659264
2022-05-06;28;34;428;-9.0;52659292
2022-05-06;984;1052;6525;956.0;52660276
2022-05-06;169;183;1057;-815.0;52660445
2022-05-06;123;129;1071;-46.0;52660568
2022-05-06;20;23;272;-103.0;52660588
2022-05-06;25;26;1;5.0;52660613
2022-05-06;133;106;642;108.0;52660746
2022-05-06;22;27;372;-111.0;52660768
2022-05-06;180;189;455;158.0;52660948
2022-05-06;34;42;369;-146.0;52660982
2022-05-06;102;110;869;68.0;52661084
2022-05-07;68;61;512;-34.0;52661152
2022-05-07;49;56;336;-19.0;52661201
2022-05-07;41;39;377;-8.0;52661242
2022-05-07;16;14;122;-25.0;52661258
2022-05-07;2;2;0;-14.0;52661260
2022-05-07;14;19;161;12.0;52661274
2022-05-07;114;98;285;100.0;52661388
2022-05-07;9;7;130;-105.0;52661397
2022-05-07;35;59;4;26.0;52661432
2022-05-07;65;62;9;30.0;52661497
2022-05-07;70;78;577;5.0;52661567
2022-05-07;2;7;91;-68.0;52661569
2022-05-07;47;48;307;45.0;52661616
2022-05-07;2;9;85;-45.0;52661618
2022-05-07;534;559;2996;532.0;52662152
2022-05-08;0;3;23;-534.0;52662152
2022-05-08;21;18;38;21.0;52662173
2022-05-08;22;20;102;1.0;52662195
2022-05-08;26;40;149;4.0;52662221
2022-05-08;0;0;0;-26.0;52662221
2022-05-08;5;5;18;5.0;52662226
2022-05-08;2;1;11;-3.0;52662228
2022-05-08;3;4;18;1.0;52662231
2022-05-08;139;154;607;136.0;52662370
2022-05-08;3;3;1;-136.0;52662373
2022-05-08;14;14;71;11.0;52662387
2022-05-08;7;7;27;-7.0;52662394
2022-05-08;2;2;4;-5.0;52662396
2022-05-08;19;27;79;17.0;52662415
2022-05-08;15;10;66;-4.0;52662430
2022-05-09;632;608;4378;617.0;52663062
2022-05-09;21;30;223;-611.0;52663083
2022-05-09;133;109;892;112.0;52663216
2022-05-09;90;97;687;-43.0;52663306
2022-05-09;67;54;495;-23.0;52663373
2022-05-09;16;17;228;-51.0;52663389
2022-05-09;78;80;195;62.0;52663467
2022-05-09;0;0;0;-78.0;52663467
2022-05-09;11;11;161;11.0;52663478
2022-05-09;9;12;199;-2.0;52663487
2022-05-09;92;81;510;83.0;52663579
2022-05-09;17;21;4;-75.0;52663596
2022-05-09;8;11;6;-9.0;52663604
2022-05-09;24;25;268;16.0;52663628
2022-05-09;66;60;510;42.0;52663694
2022-05-10;87;134;613;21.0;52663781
2022-05-10;29;29;450;-58.0;52663810
2022-05-10;33;37;340;4.0;52663843
2022-05-10;790;978;5770;757.0;52664633
2022-05-10;131;196;952;-659.0;52664764
2022-05-10;30;31;351;-101.0;52664794
2022-05-10;29;25;15;-1.0;52664823
2022-05-10;121;116;278;92.0;52664944
2022-05-10;13;21;1;-108.0;52664957
2022-05-10;79;102;763;66.0;52665036
2022-05-10;49;51;368;-30.0;52665085
2022-05-10;72;101;515;23.0;52665157
2022-05-10;19;13;269;-53.0;52665176
2022-05-10;96;121;853;77.0;52665272
2022-05-10;2;1;2;-94.0;52665274
2022-05-11;73;100;457;71.0;52665347
2022-05-11;14;21;232;-59.0;52665361
2022-05-11;70;92;558;56.0;52665431
2022-05-11;9;18;196;-61.0;52665440
2022-05-11;109;159;845;100.0;52665549
2022-05-11;872;1089;4663;763.0;52666421
2022-05-11;20;20;319;-852.0;52666441
2022-05-11;1;0;1;-19.0;52666442
2022-05-11;18;23;237;17.0;52666460
2022-05-11;107;141;703;89.0;52666567
2022-05-11;180;201;371;73.0;52666747
2022-05-11;55;82;449;-125.0;52666802
2022-05-11;99;113;7;44.0;52666901
2022-05-11;29;32;281;-70.0;52666930
2022-05-11;88;87;7;59.0;52667018
2022-05-12;29;28;287;-59.0;52667047
2022-05-12;42;76;381;13.0;52667089
2022-05-12;78;88;586;36.0;52667167
2022-05-12;97;103;238;19.0;52667264
2022-05-12;33;33;373;-64.0;52667297
2022-05-12;122;143;719;89.0;52667419
2022-05-12;34;48;367;-88.0;52667453
2022-05-12;9;13;0;-25.0;52667462
2022-05-12;21;22;5;12.0;52667483
2022-05-12;28;29;305;7.0;52667511
2022-05-12;92;112;696;64.0;52667603
2022-05-12;684;815;4686;592.0;52668287
2022-05-12;17;10;247;-667.0;52668304
2022-05-12;0;2;0;-17.0;52668304
2022-05-12;82;108;482;82.0;52668386
2022-05-13;79;78;472;-3.0;52668465
2022-05-13;136;152;983;57.0;52668601
2022-05-13;839;918;5885;703.0;52669440
2022-05-13;154;154;445;-685.0;52669594
2022-05-13;76;83;796;-78.0;52669670
2022-05-13;48;60;5;-28.0;52669718
2022-05-13;32;19;354;-16.0;52669750
2022-05-13;36;34;321;4.0;52669786
2022-05-13;22;22;0;-14.0;52669808
2022-05-13;15;24;241;-7.0;52669823
2022-05-13;1;2;1;-14.0;52669824
2022-05-13;20;38;365;19.0;52669844
2022-05-13;36;33;430;16.0;52669880
2022-05-13;98;118;918;62.0;52669978
2022-05-13;86;101;554;-12.0;52670064
2022-05-14;531;527;2623;445.0;52670595
2022-05-14;9;12;111;-522.0;52670604
2022-05-14;75;67;450;66.0;52670679
2022-05-14;77;75;7;2.0;52670756
2022-05-14;58;68;430;-19.0;52670814
2022-05-14;37;35;299;-21.0;52670851
2022-05-14;47;46;324;10.0;52670898
2022-05-14;105;103;319;58.0;52671003
2022-05-14;44;45;2;-61.0;52671047
2022-05-14;13;8;106;-31.0;52671060
2022-05-14;39;39;253;26.0;52671099
2022-05-14;6;7;93;-33.0;52671105
2022-05-14;12;14;137;6.0;52671117
2022-05-14;9;8;92;-3.0;52671126
2022-05-14;0;0;0;-9.0;52671126
2022-05-15;1;1;1;1.0;52671127
2022-05-15;11;22;83;10.0;52671138
2022-05-15;5;4;1;-6.0;52671143
2022-05-15;1;0;17;-4.0;52671144
2022-05-15;3;0;21;2.0;52671147
2022-05-15;1;0;26;-2.0;52671148
2022-05-15;4;8;3;3.0;52671152
2022-05-15;9;10;79;5.0;52671161
2022-05-15;20;20;81;11.0;52671181
2022-05-15;25;19;110;5.0;52671206
2022-05-15;136;148;636;111.0;52671342
2022-05-15;3;6;27;-133.0;52671345
2022-05-15;18;20;52;15.0;52671363
2022-05-15;3;1;17;-15.0;52671366
2022-05-15;32;37;118;29.0;52671398
2022-05-16;18;16;8;-14.0;52671416
2022-05-16;65;66;569;47.0;52671481
2022-05-16;47;60;413;-18.0;52671528
2022-05-16;513;516;3871;466.0;52672041
2022-05-16;18;17;207;-495.0;52672059
2022-05-16;90;99;719;72.0;52672149
2022-05-16;20;22;198;-70.0;52672169
2022-05-16;14;9;149;-6.0;52672183
2022-05-16;67;72;467;53.0;52672250
2022-05-16;46;59;462;-21.0;52672296
2022-05-16;0;0;0;-46.0;52672296
2022-05-16;77;50;233;77.0;52672373
2022-05-16;16;15;188;-61.0;52672389
2022-05-16;19;15;256;3.0;52672408
2022-05-16;16;16;2;-3.0;52672424
2022-05-17;108;131;831;92.0;52672532
2022-05-17;100;102;757;-8.0;52672632
2022-05-17;67;75;631;-33.0;52672699
2022-05-17;29;28;10;-38.0;52672728
2022-05-17;20;19;209;-9.0;52672748
2022-05-17;32;30;338;12.0;52672780
2022-05-17;26;23;328;-6.0;52672806
2022-05-17;56;62;418;30.0;52672862
2022-05-17;677;726;5028;621.0;52673539
2022-05-17;105;96;294;-572.0;52673644
2022-05-17;21;29;344;-84.0;52673665
2022-05-17;18;14;3;-3.0;52673683
2022-05-17;30;31;326;12.0;52673713
2022-05-17;0;1;0;-30.0;52673713
2022-05-17;65;85;539;65.0;52673778
2022-05-18;11;15;173;-54.0;52673789
2022-05-18;113;126;690;102.0;52673902
2022-05-18;71;76;651;-42.0;52673973
2022-05-18;16;23;241;-55.0;52673989
2022-05-18;69;87;531;53.0;52674058
2022-05-18;87;88;15;18.0;52674145
2022-05-18;1;2;1;-86.0;52674146
2022-05-18;70;76;454;69.0;52674216
2022-05-18;795;836;4357;725.0;52675011
2022-05-18;24;15;256;-771.0;52675035
2022-05-18;56;74;8;32.0;52675091
2022-05-18;27;26;236;-29.0;52675118
2022-05-18;48;58;420;21.0;52675166
2022-05-18;168;140;409;120.0;52675334
2022-05-18;34;30;272;-134.0;52675368
2022-05-19;31;29;316;-3.0;52675399
2022-05-19;611;719;4667;580.0;52676010
2022-05-19;27;24;338;-584.0;52676037
2022-05-19;77;93;450;50.0;52676114
2022-05-19;16;31;325;-61.0;52676130
2022-05-19;11;10;2;-5.0;52676141
2022-05-19;79;101;664;68.0;52676220
2022-05-19;88;107;756;9.0;52676308
2022-05-19;99;104;266;11.0;52676407
2022-05-19;20;29;13;-79.0;52676427
2022-05-19;19;20;381;-1.0;52676446
2022-05-19;56;59;373;37.0;52676502
2022-05-19;1;1;0;-55.0;52676503
2022-05-19;14;16;212;13.0;52676517
2022-05-19;73;95;571;59.0;52676590
2022-05-20;20;22;321;-53.0;52676610
2022-05-20;31;27;368;11.0;52676641
2022-05-20;13;20;5;-18.0;52676654
2022-05-20;89;87;583;76.0;52676743
2022-05-20;78;89;778;-11.0;52676821
2022-05-20;796;888;5795;718.0;52677617
2022-05-20;19;21;205;-777.0;52677636
2022-05-20;95;127;903;76.0;52677731
2022-05-20;137;165;955;42.0;52677868
2022-05-20;66;68;426;-71.0;52677934
2022-05-20;0;0;0;-66.0;52677934
2022-05-20;43;30;348;43.0;52677977
2022-05-20;148;152;482;105.0;52678125
2022-05-20;30;38;415;-118.0;52678155
2022-05-20;27;42;6;-3.0;52678182
2022-05-21;9;12;81;-18.0;52678191
2022-05-21;62;62;452;53.0;52678253
2022-05-21;52;51;5;-10.0;52678305
2022-05-21;104;100;313;52.0;52678409
2022-05-21;14;16;122;-90.0;52678423
2022-05-21;64;68;297;50.0;52678487
2022-05-21;5;7;77;-59.0;52678492
2022-05-21;39;28;299;34.0;52678531
2022-05-21;64;69;457;25.0;52678595
2022-05-21;85;88;13;21.0;52678680
2022-05-21;540;569;2487;455.0;52679220
2022-05-21;5;8;58;-535.0;52679225
2022-05-21;32;41;213;27.0;52679257
2022-05-21;5;18;98;-27.0;52679262
2022-05-21;0;1;2;-5.0;52679262
2022-05-22;118;128;454;118.0;52679380
2022-05-22;0;1;19;-118.0;52679380
2022-05-22;3;2;9;3.0;52679383
2022-05-22;2;5;10;-1.0;52679385
2022-05-22;14;14;58;12.0;52679399
2022-05-22;4;8;24;-10.0;52679403
2022-05-22;12;12;47;8.0;52679415
2022-05-22;2;0;12;-10.0;52679417
2022-05-22;0;0;0;-2.0;52679417
2022-05-22;13;12;48;13.0;52679430
2022-05-22;24;22;42;11.0;52679454
2022-05-22;9;10;0;-15.0;52679463
2022-05-22;11;19;77;2.0;52679474
2022-05-22;17;21;108;6.0;52679491
2022-05-22;7;2;0;-10.0;52679498
2022-05-23;19;30;209;12.0;52679517
2022-05-23;90;82;260;71.0;52679607
2022-05-23;7;7;127;-83.0;52679614
2022-05-23;12;16;189;5.0;52679626
2022-05-23;46;50;415;34.0;52679672
2022-05-23;44;60;447;-2.0;52679716
2022-05-23;19;21;192;-25.0;52679735
2022-05-23;11;13;6;-8.0;52679746
2022-05-23;524;597;3903;513.0;52680270
2022-05-23;70;81;477;-454.0;52680340
2022-05-23;89;104;746;19.0;52680429
2022-05-23;25;20;181;-64.0;52680454
2022-05-23;0;1;0;-25.0;52680454
2022-05-23;74;93;638;74.0;52680528
2022-05-23;18;19;16;-56.0;52680546
2022-05-24;26;36;284;8.0;52680572
2022-05-24;20;20;200;-6.0;52680592
2022-05-24;48;61;660;28.0;52680640
2022-05-24;73;79;507;25.0;52680713
2022-05-24;24;21;314;-49.0;52680737
2022-05-24;122;118;359;98.0;52680859
2022-05-24;123;116;736;1.0;52680982
2022-05-24;12;22;7;-111.0;52680994
2022-05-24;20;27;13;8.0;52681014
2022-05-24;78;104;701;58.0;52681092
2022-05-24;30;24;348;-48.0;52681122
2022-05-24;20;31;372;-10.0;52681142
2022-05-24;0;0;1;-20.0;52681142
2022-05-24;643;716;4860;643.0;52681785
2022-05-24;47;57;358;-596.0;52681832
2022-05-25;73;89;508;26.0;52681905
2022-05-25;807;959;4130;734.0;52682712
2022-05-25;47;65;334;-760.0;52682759
2022-05-25;2;2;1;-45.0;52682761
2022-05-25;62;76;427;60.0;52682823
2022-05-25;115;136;16;53.0;52682938
2022-05-25;18;24;224;-97.0;52682956
2022-05-25;82;98;581;64.0;52683038
2022-05-25;24;15;225;-58.0;52683062
2022-05-25;28;19;247;4.0;52683090
2022-05-25;29;30;237;1.0;52683119
2022-05-25;167;187;492;138.0;52683286
2022-05-25;54;84;3;-113.0;52683340
2022-05-25;9;13;161;-45.0;52683349
2022-05-25;97;121;674;88.0;52683446
2022-05-26;24;32;198;-73.0;52683470
2022-05-26;11;24;129;-13.0;52683481
2022-05-26;2;1;20;-9.0;52683483
2022-05-26;2;0;1;0.0;52683485
2022-05-26;2;1;15;0.0;52683487
2022-05-26;6;16;96;4.0;52683493
2022-05-26;7;15;79;1.0;52683500
2022-05-26;94;138;814;87.0;52683594
2022-05-26;1;2;19;-93.0;52683595
2022-05-26;0;0;15;-1.0;52683595
2022-05-26;14;16;120;14.0;52683609
2022-05-26;3;6;24;-11.0;52683612
2022-05-26;3;3;1;0.0;52683615
2022-05-26;7;6;3;4.0;52683622
2022-05-26;12;16;94;5.0;52683634
2022-05-27;0;0;2;-12.0;52683634
2022-05-27;52;51;311;52.0;52683686
2022-05-27;20;19;3;-32.0;52683706
2022-05-27;14;7;144;-6.0;52683720
2022-05-27;65;94;662;51.0;52683785
2022-05-27;75;87;451;10.0;52683860
2022-05-27;12;15;198;-63.0;52683872
2022-05-27;24;24;243;12.0;52683896
2022-05-27;144;151;471;120.0;52684040
2022-05-27;13;30;185;-131.0;52684053
2022-05-27;16;10;143;3.0;52684069
2022-05-27;81;122;716;65.0;52684150
2022-05-27;43;58;13;-38.0;52684193
2022-05-27;59;63;541;16.0;52684252
2022-05-27;618;731;4083;559.0;52684870
2022-05-28;7;12;72;-611.0;52684877
2022-05-28;15;20;1;8.0;52684892
2022-05-28;8;13;90;-7.0;52684900
2022-05-28;37;53;325;29.0;52684937
2022-05-28;41;70;284;4.0;52684978
2022-05-28;4;2;56;-37.0;52684982
2022-05-28;19;28;166;15.0;52685001
2022-05-28;77;97;244;58.0;52685078
2022-05-28;303;399;1813;226.0;52685381
2022-05-28;21;31;242;-282.0;52685402
2022-05-28;38;37;7;17.0;52685440
2022-05-28;3;0;42;-35.0;52685443
2022-05-28;2;4;65;-1.0;52685445
2022-05-28;1;0;0;-1.0;52685446
2022-05-28;30;32;219;29.0;52685476
2022-05-29;4;7;56;-26.0;52685480
2022-05-29;2;3;16;-2.0;52685482
2022-05-29;4;0;11;2.0;52685486
2022-05-29;12;9;37;8.0;52685498
2022-05-29;0;1;7;-12.0;52685498
2022-05-29;0;1;11;0.0;52685498
2022-05-29;12;14;81;12.0;52685510
2022-05-29;0;0;0;-12.0;52685510
2022-05-29;7;11;65;7.0;52685517
2022-05-29;18;18;36;11.0;52685535
2022-05-29;1;1;7;-17.0;52685536
2022-05-29;81;89;364;80.0;52685617
2022-05-29;12;11;35;-69.0;52685629
2022-05-29;7;9;2;-5.0;52685636
2022-05-29;2;4;0;-5.0;52685638
2022-05-30;58;85;570;56.0;52685696
2022-05-30;1;0;0;-57.0;52685697
2022-05-30;413;542;3049;412.0;52686110
2022-05-30;15;21;160;-398.0;52686125
2022-05-30;15;10;165;0.0;52686140
2022-05-30;17;28;15;2.0;52686157
2022-05-30;63;77;480;46.0;52686220
2022-05-30;7;9;174;-56.0;52686227
2022-05-30;20;18;188;13.0;52686247
2022-05-30;9;7;81;-11.0;52686256
2022-05-30;28;53;289;19.0;52686284
2022-05-30;55;82;356;27.0;52686339
2022-05-30;11;7;1;-44.0;52686350
2022-05-30;43;53;339;32.0;52686393
2022-05-30;71;92;231;28.0;52686464
2022-05-31;15;16;1;-56.0;52686479
2022-05-31;22;29;325;7.0;52686501
2022-05-31;35;27;254;13.0;52686536
2022-05-31;14;11;163;-21.0;52686550
2022-05-31;1;3;0;-13.0;52686551
2022-05-31;72;95;410;71.0;52686623
2022-05-31;27;42;5;-45.0;52686650
2022-05-31;634;721;4102;607.0;52687284
2022-05-31;120;105;313;-514.0;52687404
2022-05-31;24;29;284;-96.0;52687428
2022-05-31;39;55;290;15.0;52687467
2022-05-31;63;75;495;24.0;52687530
2022-05-31;105;132;639;42.0;52687635
2022-05-31;71;88;652;-34.0;52687706
2022-05-31;26;14;271;-45.0;52687732
2022-06-01;78;108;853;52.0;52687810
2022-06-01;19;11;192;-59.0;52687829
2022-06-01;14;18;219;-5.0;52687843
2022-06-01;21;30;211;7.0;52687864
2022-06-01;33;44;244;12.0;52687897
2022-06-01;17;15;127;-16.0;52687914
2022-06-01;174;197;647;157.0;52688088
2022-06-01;0;2;1;-174.0;52688088
2022-06-01;58;72;508;58.0;52688146
2022-06-01;72;127;551;14.0;52688218
2022-06-01;108;156;896;36.0;52688326
2022-06-01;101;115;33;-7.0;52688427
2022-06-01;61;75;10;-40.0;52688488
2022-06-01;813;1054;4899;752.0;52689301
2022-06-01;57;84;407;-756.0;52689358
2022-06-02;16;15;187;-41.0;52689374
2022-06-02;32;33;313;16.0;52689406
2022-06-02;115;135;423;83.0;52689521
2022-06-02;89;82;526;-26.0;52689610
2022-06-02;22;26;25;-67.0;52689632
2022-06-02;30;23;281;8.0;52689662
2022-06-02;21;22;262;-9.0;52689683
2022-06-02;23;38;260;2.0;52689706
2022-06-02;55;59;373;32.0;52689761
2022-06-02;112;131;799;57.0;52689873
2022-06-02;59;69;606;-53.0;52689932
2022-06-02;19;11;3;-40.0;52689951
2022-06-02;74;99;782;55.0;52690025
2022-06-02;667;743;4840;593.0;52690692
2022-06-02;0;0;0;-667.0;52690692
2022-06-03;67;97;962;67.0;52690759
2022-06-03;118;134;1002;51.0;52690877
2022-06-03;57;67;437;-61.0;52690934
2022-06-03;33;32;314;-24.0;52690967
2022-06-03;87;109;613;54.0;52691054
2022-06-03;67;98;696;-20.0;52691121
2022-06-03;19;15;4;-48.0;52691140
2022-06-03;23;23;286;4.0;52691163
2022-06-03;25;15;173;2.0;52691188
2022-06-03;25;19;230;0.0;52691213
2022-06-03;0;0;0;-25.0;52691213
2022-06-03;30;52;31;30.0;52691243
2022-06-03;758;896;5746;728.0;52692001
2022-06-03;29;41;356;-729.0;52692030
2022-06-03;178;194;642;149.0;52692208
2022-06-04;5;7;46;-173.0;52692213
2022-06-04;53;61;426;48.0;52692266
2022-06-04;114;110;376;61.0;52692380
2022-06-04;14;13;84;-100.0;52692394
2022-06-04;45;48;274;31.0;52692439
2022-06-04;25;26;191;-20.0;52692464
2022-06-04;31;38;2;6.0;52692495
2022-06-04;39;31;241;8.0;52692534
2022-06-04;54;70;12;15.0;52692588
2022-06-04;2;1;0;-52.0;52692590
2022-06-04;3;2;50;1.0;52692593
2022-06-04;11;3;80;8.0;52692604
2022-06-04;445;472;2333;434.0;52693049
2022-06-04;10;16;115;-435.0;52693059
2022-06-04;39;46;436;29.0;52693098
2022-06-05;6;5;2;-33.0;52693104
2022-06-05;14;16;79;8.0;52693118
2022-06-05;6;13;56;-8.0;52693124
2022-06-05;1;5;11;-5.0;52693125
2022-06-05;2;1;3;1.0;52693127
2022-06-05;4;10;48;2.0;52693131
2022-06-05;75;104;402;71.0;52693206
2022-06-05;15;16;72;-60.0;52693221
2022-06-05;0;0;0;-15.0;52693221
2022-06-05;6;16;26;6.0;52693227
2022-06-05;15;14;76;9.0;52693242
2022-06-05;0;0;18;-15.0;52693242
2022-06-05;5;6;0;5.0;52693247
2022-06-05;1;1;8;-4.0;52693248
2022-06-05;0;1;3;-1.0;52693248
2022-06-06;2;5;24;2.0;52693250
2022-06-06;3;10;13;1.0;52693253
2022-06-06;82;99;145;79.0;52693335
2022-06-06;35;49;103;-47.0;52693370
2022-06-06;3;8;12;-32.0;52693373
2022-06-06;49;67;128;46.0;52693422
2022-06-06;3;3;18;-46.0;52693425
2022-06-06;487;580;1084;484.0;52693912
2022-06-06;10;12;32;-477.0;52693922
2022-06-06;62;81;218;52.0;52693984
2022-06-06;1;2;2;-61.0;52693985
2022-06-06;77;83;119;76.0;52694062
2022-06-06;13;11;0;-64.0;52694075
2022-06-06;140;137;263;127.0;52694215
2022-06-06;7;13;7;-133.0;52694222
2022-06-07;11;16;0;4.0;52694233
2022-06-07;24;26;240;13.0;52694257
2022-06-07;25;31;269;1.0;52694282
2022-06-07;111;134;689;86.0;52694393
2022-06-07;24;20;205;-87.0;52694417
2022-06-07;9;7;153;-15.0;52694426
2022-06-07;19;22;244;10.0;52694445
2022-06-07;102;88;479;83.0;52694547
2022-06-07;71;78;509;-31.0;52694618
2022-06-07;74;104;654;3.0;52694692
2022-06-07;20;33;11;-54.0;52694712
2022-06-07;63;67;332;43.0;52694775
2022-06-07;0;0;1;-63.0;52694775
2022-06-07;672;758;4126;672.0;52695447
2022-06-07;119;132;340;-553.0;52695566
2022-06-08;46;70;475;-73.0;52695612
2022-06-08;16;13;124;-30.0;52695628
2022-06-08;715;875;4007;699.0;52696343
2022-06-08;52;74;3;-663.0;52696395
2022-06-08;89;96;609;37.0;52696484
2022-06-08;0;0;1;-89.0;52696484
2022-06-08;22;28;235;22.0;52696506
2022-06-08;97;122;23;75.0;52696603
2022-06-08;34;31;196;-63.0;52696637
2022-06-08;16;19;215;-18.0;52696653
2022-06-08;14;15;175;-2.0;52696667
2022-06-08;148;190;609;134.0;52696815
2022-06-08;73;93;590;-75.0;52696888
2022-06-08;37;51;289;-36.0;52696925
2022-06-08;71;73;463;34.0;52696996
2022-06-09;82;98;708;11.0;52697078
2022-06-09;16;16;4;-66.0;52697094
2022-06-09;12;19;255;-4.0;52697106
2022-06-09;20;34;14;8.0;52697126
2022-06-09;81;94;751;61.0;52697207
2022-06-09;555;691;4528;474.0;52697762
2022-06-09;54;78;486;-501.0;52697816
2022-06-09;70;99;521;16.0;52697886
2022-06-09;16;23;241;-54.0;52697902
2022-06-09;11;18;164;-5.0;52697913
2022-06-09;22;24;297;11.0;52697935
2022-06-09;107;113;469;85.0;52698042
2022-06-09;18;22;268;-89.0;52698060
2022-06-09;46;53;350;28.0;52698106
2022-06-09;0;0;0;-46.0;52698106
2022-06-10;86;113;927;86.0;52698192
2022-06-10;20;29;5;-66.0;52698212
2022-06-10;33;44;344;13.0;52698245
2022-06-10;709;939;5716;676.0;52698954
2022-06-10;50;87;399;-659.0;52699004
2022-06-10;60;79;691;10.0;52699064
2022-06-10;32;24;317;-28.0;52699096
2022-06-10;25;31;323;-7.0;52699121
2022-06-10;10;10;180;-15.0;52699131
2022-06-10;18;17;237;8.0;52699149
2022-06-10;1;1;1;-17.0;52699150
2022-06-10;64;107;596;63.0;52699214
2022-06-10;163;178;654;99.0;52699377
2022-06-10;36;50;33;-127.0;52699413
2022-06-10;111;169;1009;75.0;52699524
2022-06-11;46;63;435;-65.0;52699570
2022-06-11;4;7;62;-42.0;52699574
2022-06-11;442;547;2542;438.0;52700016
2022-06-11;71;83;18;-371.0;52700087
2022-06-11;4;6;54;-67.0;52700091
2022-06-11;10;13;135;6.0;52700101
2022-06-11;9;8;104;-1.0;52700110
2022-06-11;106;149;426;97.0;52700216
2022-06-11;44;52;271;-62.0;52700260
2022-06-11;36;43;1;-8.0;52700296
2022-06-11;0;0;1;-36.0;52700296
2022-06-11;45;48;441;45.0;52700341
2022-06-11;29;27;213;-16.0;52700370
2022-06-11;8;8;92;-21.0;52700378
2022-06-11;30;40;289;22.0;52700408
2022-06-12;12;18;86;-18.0;52700420
2022-06-12;0;8;70;-12.0;52700420
2022-06-12;19;18;95;19.0;52700439
2022-06-12;4;4;15;-15.0;52700443
2022-06-12;7;5;2;3.0;52700450
2022-06-12;0;0;0;-7.0;52700450
2022-06-12;5;6;19;5.0;52700455
2022-06-12;2;1;12;-3.0;52700457
2022-06-12;0;2;7;-2.0;52700457
2022-06-12;1;6;2;1.0;52700458
2022-06-12;94;125;521;93.0;52700552
2022-06-12;26;24;87;-68.0;52700578
2022-06-12;1;4;10;-25.0;52700579
2022-06-12;7;17;57;6.0;52700586
2022-06-12;10;12;59;3.0;52700596
2022-06-13;43;53;421;33.0;52700639
2022-06-13;22;22;2;-21.0;52700661
2022-06-13;0;0;0;-22.0;52700661
2022-06-13;17;13;143;17.0;52700678
2022-06-13;513;599;3245;496.0;52701191
2022-06-13;18;20;194;-495.0;52701209
2022-06-13;59;67;550;41.0;52701268
2022-06-13;46;62;251;-13.0;52701314
2022-06-13;75;107;539;29.0;52701389
2022-06-13;94;117;367;19.0;52701483
2022-06-13;13;18;156;-81.0;52701496
2022-06-13;29;28;17;16.0;52701525
2022-06-13;8;11;77;-21.0;52701533
2022-06-13;81;74;424;73.0;52701614
2022-06-13;8;7;104;-73.0;52701622
2022-06-14;626;676;4391;618.0;52702248
2022-06-14;70;84;701;-556.0;52702318
2022-06-14;29;22;298;-41.0;52702347
2022-06-14;20;25;7;-9.0;52702367
2022-06-14;22;17;202;2.0;52702389
2022-06-14;23;16;153;1.0;52702412
2022-06-14;0;1;0;-23.0;52702412
2022-06-14;40;34;255;40.0;52702452
2022-06-14;23;25;11;-17.0;52702475
2022-06-14;46;53;323;23.0;52702521
2022-06-14;49;63;565;3.0;52702570
2022-06-14;69;75;456;20.0;52702639
2022-06-14;87;134;674;18.0;52702726
2022-06-14;116;101;419;29.0;52702842
2022-06-14;32;26;327;-84.0;52702874
2022-06-15;29;40;242;-3.0;52702903
2022-06-15;147;185;547;118.0;52703050
2022-06-15;0;0;0;-147.0;52703050
2022-06-15;51;61;452;51.0;52703101
2022-06-15;22;18;212;-29.0;52703123
2022-06-15;25;22;203;3.0;52703148
2022-06-15;46;69;456;21.0;52703194
2022-06-15;689;877;4075;643.0;52703883
2022-06-15;11;12;146;-678.0;52703894
2022-06-15;44;65;333;33.0;52703938
2022-06-15;49;92;8;5.0;52703987
2022-06-15;95;93;665;46.0;52704082
2022-06-15;7;7;129;-88.0;52704089
2022-06-15;84;117;26;77.0;52704173
2022-06-15;79;96;656;-5.0;52704252
2022-06-16;50;67;473;-29.0;52704302
2022-06-16;2;3;0;-48.0;52704304
2022-06-16;13;11;217;11.0;52704317
2022-06-16;21;22;230;8.0;52704338
2022-06-16;84;101;503;63.0;52704422
2022-06-16;12;18;19;-72.0;52704434
2022-06-16;54;65;458;42.0;52704488
2022-06-16;497;544;4144;443.0;52704985
2022-06-16;67;69;651;-430.0;52705052
2022-06-16;16;10;198;-51.0;52705068
2022-06-16;81;80;683;65.0;52705149
2022-06-16;14;9;152;-67.0;52705163
2022-06-16;51;52;289;37.0;52705214
2022-06-16;10;11;5;-41.0;52705224
2022-06-16;22;26;266;12.0;52705246
2022-06-17;135;199;738;113.0;52705381
2022-06-17;27;32;253;-108.0;52705408
2022-06-17;41;41;28;14.0;52705449
2022-06-17;27;33;311;-14.0;52705476
2022-06-17;77;101;925;50.0;52705553
2022-06-17;17;19;276;-60.0;52705570
2022-06-17;26;13;208;9.0;52705596
2022-06-17;22;27;4;-4.0;52705618
2022-06-17;86;93;880;64.0;52705704
2022-06-17;667;815;5477;581.0;52706371
2022-06-17;82;90;590;-585.0;52706453
2022-06-17;12;15;152;-70.0;52706465
2022-06-17;0;0;3;-12.0;52706465
2022-06-17;56;66;386;56.0;52706521
2022-06-17;59;86;723;3.0;52706580
2022-06-18;6;10;48;-53.0;52706586
2022-06-18;50;64;350;44.0;52706636
2022-06-18;12;21;152;-38.0;52706648
2022-06-18;0;1;0;-12.0;52706648
2022-06-18;94;117;406;94.0;52706742
2022-06-18;7;3;76;-87.0;52706749
2022-06-18;6;7;49;-1.0;52706755
2022-06-18;42;57;16;36.0;52706797
2022-06-18;11;6;81;-31.0;52706808
2022-06-18;26;46;235;15.0;52706834
2022-06-18;31;29;7;5.0;52706865
2022-06-18;13;11;99;-18.0;52706878
2022-06-18;42;58;364;29.0;52706920
2022-06-18;24;38;254;-18.0;52706944
2022-06-18;364;468;2137;340.0;52707308
2022-06-19;22;25;81;-342.0;52707330
2022-06-19;4;4;2;-18.0;52707334
2022-06-19;8;11;58;4.0;52707342
2022-06-19;0;2;9;-8.0;52707342
2022-06-19;0;0;0;0.0;52707342
2022-06-19;5;1;0;5.0;52707347
2022-06-19;1;1;18;-4.0;52707348
2022-06-19;75;94;503;74.0;52707423
2022-06-19;1;1;8;-74.0;52707424
2022-06-19;2;0;24;1.0;52707426
2022-06-19;6;10;55;4.0;52707432
2022-06-19;2;1;15;-4.0;52707434
2022-06-19;10;15;88;8.0;52707444
2022-06-19;1;5;58;-9.0;52707445
2022-06-19;13;18;87;12.0;52707458
2022-06-20;11;7;84;-2.0;52707469
2022-06-20;31;38;351;20.0;52707500
2022-06-20;9;16;10;-22.0;52707509
2022-06-20;15;14;177;6.0;52707524
2022-06-20;95;121;495;80.0;52707619
2022-06-20;52;77;696;-43.0;52707671
2022-06-20;433;532;3916;381.0;52708104
2022-06-20;17;21;197;-416.0;52708121
2022-06-20;22;27;27;5.0;52708143
2022-06-20;0;0;0;-22.0;52708143
2022-06-20;10;15;159;10.0;52708153
2022-06-20;9;7;117;-1.0;52708162
2022-06-20;45;59;433;36.0;52708207
2022-06-20;55;58;503;10.0;52708262
2022-06-20;62;72;667;7.0;52708324
2022-06-21;69;71;490;7.0;52708393
2022-06-21;45;39;273;-24.0;52708438
2022-06-21;21;36;19;-24.0;52708459
2022-06-21;25;20;279;4.0;52708484
2022-06-21;31;33;256;6.0;52708515
2022-06-21;14;17;151;-17.0;52708529
2022-06-21;107;113;603;93.0;52708636
2022-06-21;93;100;657;-14.0;52708729
2022-06-21;14;23;1;-79.0;52708743
2022-06-21;127;151;555;113.0;52708870
2022-06-21;627;700;4174;500.0;52709497
2022-06-21;15;16;223;-612.0;52709512
2022-06-21;0;0;2;-15.0;52709512
2022-06-21;42;61;457;42.0;52709554
2022-06-21;24;20;208;-18.0;52709578
2022-06-22;76;125;24;52.0;52709654
2022-06-22;60;77;393;-16.0;52709714
2022-06-22;12;25;230;-48.0;52709726
2022-06-22;35;49;406;23.0;52709761
2022-06-22;19;19;217;-16.0;52709780
2022-06-22;41;67;8;22.0;52709821
2022-06-22;17;20;165;-24.0;52709838
2022-06-22;13;11;142;-4.0;52709851
2022-06-22;158;202;665;145.0;52710009
2022-06-22;63;71;557;-95.0;52710072
2022-06-22;609;806;3777;546.0;52710681
2022-06-22;0;0;0;-609.0;52710681
2022-06-22;57;89;502;57.0;52710738
2022-06-22;38;39;250;-19.0;52710776
2022-06-22;20;12;218;-18.0;52710796
2022-06-23;65;73;568;45.0;52710861
2022-06-23;16;26;13;-49.0;52710877
2022-06-23;30;27;340;14.0;52710907
2022-06-23;19;19;284;-11.0;52710926
2022-06-23;17;16;174;-2.0;52710943
2022-06-23;47;45;541;30.0;52710990
2022-06-23;22;24;284;-25.0;52711012
2022-06-23;61;78;674;39.0;52711073
2022-06-23;19;10;244;-42.0;52711092
2022-06-23;527;582;4426;508.0;52711619
2022-06-23;1;1;0;-526.0;52711620
2022-06-23;13;12;2;12.0;52711633
2022-06-23;78;83;432;65.0;52711711
2022-06-23;37;41;255;-41.0;52711748
2022-06-23;102;127;615;65.0;52711850
2022-06-24;135;181;845;33.0;52711985
2022-06-24;28;22;297;-107.0;52712013
2022-06-24;656;776;5688;628.0;52712669
2022-06-24;55;51;320;-601.0;52712724
2022-06-24;24;33;400;-31.0;52712748
2022-06-24;66;65;725;42.0;52712814
2022-06-24;67;93;940;1.0;52712881
2022-06-24;40;49;18;-27.0;52712921
2022-06-24;74;84;592;34.0;52712995
2022-06-24;87;110;764;13.0;52713082
2022-06-24;30;21;335;-57.0;52713112
2022-06-24;12;25;1;-18.0;52713124
2022-06-24;1;0;0;-11.0;52713125
2022-06-24;19;23;255;18.0;52713144
2022-06-24;18;19;196;-1.0;52713162
2022-06-25;54;45;474;36.0;52713216
2022-06-25;4;5;77;-50.0;52713220
2022-06-25;33;32;209;29.0;52713253
2022-06-25;448;512;2837;415.0;52713701
2022-06-25;5;6;101;-443.0;52713706
2022-06-25;49;58;15;44.0;52713755
2022-06-25;45;62;399;-4.0;52713800
2022-06-25;49;55;312;4.0;52713849
2022-06-25;19;16;173;-30.0;52713868
2022-06-25;7;6;88;-12.0;52713875
2022-06-25;12;10;131;5.0;52713887
2022-06-25;103;133;498;91.0;52713990
2022-06-25;38;52;1;-65.0;52714028
2022-06-25;29;32;359;-9.0;52714057
2022-06-25;1;0;0;-28.0;52714058
2022-06-26;14;15;150;13.0;52714072
2022-06-26;5;8;76;-9.0;52714077
2022-06-26;26;31;144;21.0;52714103
2022-06-26;9;18;165;-17.0;52714112
2022-06-26;2;3;35;-7.0;52714114
2022-06-26;104;127;863;102.0;52714218
2022-06-26;7;8;108;-97.0;52714225
2022-06-26;14;13;106;7.0;52714239
2022-06-26;0;0;1;-14.0;52714239
2022-06-26;2;0;10;2.0;52714241
2022-06-26;2;8;2;0.0;52714243
2022-06-26;5;3;25;3.0;52714248
2022-06-26;14;15;7;9.0;52714262
2022-06-26;3;3;17;-11.0;52714265
2022-06-26;1;2;17;-2.0;52714266
2022-06-27;2;1;2;1.0;52714268
2022-06-27;15;17;279;13.0;52714283
2022-06-27;11;19;256;-4.0;52714294
2022-06-27;17;14;184;6.0;52714311
2022-06-27;125;118;635;108.0;52714436
2022-06-27;13;16;269;-112.0;52714449
2022-06-27;466;501;4436;453.0;52714915
2022-06-27;52;54;509;-414.0;52714967
2022-06-27;54;71;650;2.0;52715021
2022-06-27;25;33;24;-29.0;52715046
2022-06-27;10;15;3;-15.0;52715056
2022-06-27;34;35;483;24.0;52715090
2022-06-27;13;13;136;-21.0;52715103
2022-06-27;33;29;327;20.0;52715136
2022-06-27;62;66;679;29.0;52715198
2022-06-28;89;81;733;27.0;52715287
2022-06-28;37;31;458;-52.0;52715324
2022-06-28;73;93;563;36.0;52715397
2022-06-28;33;48;20;-40.0;52715430
2022-06-28;165;178;791;132.0;52715595
2022-06-28;24;27;444;-141.0;52715619
2022-06-28;67;70;664;43.0;52715686
2022-06-28;18;16;482;-49.0;52715704
2022-06-28;19;19;268;1.0;52715723
2022-06-28;31;36;340;12.0;52715754
2022-06-28;13;14;0;-18.0;52715767
2022-06-28;27;24;317;14.0;52715794
2022-06-28;0;1;2;-27.0;52715794
2022-06-28;666;714;5917;666.0;52716460
2022-06-28;70;76;835;-596.0;52716530
2022-06-29;29;23;369;-41.0;52716559
2022-06-29;57;65;661;28.0;52716616
2022-06-29;67;65;602;10.0;52716683
2022-06-29;37;26;271;-30.0;52716720
2022-06-29;73;85;7;36.0;52716793
2022-06-29;781;868;4996;708.0;52717574
2022-06-29;100;157;29;-681.0;52717674
2022-06-29;68;73;479;-32.0;52717742
2022-06-29;63;92;628;-5.0;52717805
2022-06-29;37;36;286;-26.0;52717842
2022-06-29;17;16;223;-20.0;52717859
2022-06-29;29;22;350;12.0;52717888
2022-06-29;2;1;1;-27.0;52717890
2022-06-29;171;191;737;169.0;52718061
2022-06-29;31;16;353;-140.0;52718092
2022-06-30;30;57;312;-1.0;52718122
2022-06-30;654;733;5764;624.0;52718776
2022-06-30;16;18;5;-638.0;52718792
2022-06-30;143;155;760;127.0;52718935
2022-06-30;28;26;436;-115.0;52718963
2022-06-30;1;0;0;-27.0;52718964
2022-06-30;64;76;527;63.0;52719028
2022-06-30;57;73;632;-7.0;52719085
2022-06-30;39;34;525;-18.0;52719124
2022-06-30;33;25;439;-6.0;52719157
2022-06-30;75;83;744;42.0;52719232
2022-06-30;35;41;10;-40.0;52719267
2022-06-30;73;99;728;38.0;52719340
2022-06-30;24;15;295;-49.0;52719364
2022-06-30;36;31;351;12.0;52719400
2022-07-01;142;156;1397;106.0;52719542
2022-07-01;219;249;1157;77.0;52719761
2022-07-01;32;25;342;-187.0;52719793
2022-07-01;64;68;962;32.0;52719857
2022-07-01;57;62;41;-7.0;52719914
2022-07-01;23;31;7;-34.0;52719937
2022-07-01;38;23;341;15.0;52719975
2022-07-01;34;44;628;-4.0;52720009
2022-07-01;62;75;622;28.0;52720071
2022-07-01;0;1;4;-62.0;52720071
2022-07-01;925;1037;8969;925.0;52720996
2022-07-01;90;123;1358;-835.0;52721086
2022-07-01;37;36;569;-53.0;52721123
2022-07-01;33;22;570;-4.0;52721156
2022-07-01;94;122;971;61.0;52721250
2022-07-02;13;19;158;-81.0;52721263
2022-07-02;9;10;133;-4.0;52721272
2022-07-02;53;49;609;44.0;52721325
2022-07-02;61;75;17;8.0;52721386
2022-07-02;39;48;425;-22.0;52721425
2022-07-02;10;8;156;-29.0;52721435
2022-07-02;128;123;652;118.0;52721563
2022-07-02;18;11;206;-110.0;52721581
2022-07-02;519;514;3643;501.0;52722100
2022-07-02;63;61;546;-456.0;52722163
2022-07-02;45;38;405;-18.0;52722208
2022-07-02;44;40;4;-1.0;52722252
2022-07-02;24;27;235;-20.0;52722276
2022-07-02;11;5;97;-13.0;52722287
2022-07-02;1;0;0;-10.0;52722288
2022-07-03;6;4;38;5.0;52722294
2022-07-03;8;13;145;2.0;52722302
2022-07-03;7;6;37;-1.0;52722309
2022-07-03;14;14;84;7.0;52722323
2022-07-03;7;10;0;-7.0;52722330
2022-07-03;3;4;20;-4.0;52722333
2022-07-03;13;13;126;10.0;52722346
2022-07-03;0;0;1;-13.0;52722346
2022-07-03;130;150;869;130.0;52722476
2022-07-03;22;29;153;-108.0;52722498
2022-07-03;22;25;130;0.0;52722520
2022-07-03;5;3;17;-17.0;52722525
2022-07-03;10;14;4;5.0;52722535
2022-07-03;5;6;34;-5.0;52722540
2022-07-03;8;9;80;3.0;52722548
2022-07-04;144;193;826;136.0;52722692
2022-07-04;19;22;210;-125.0;52722711
2022-07-04;4;3;0;-15.0;52722715
2022-07-04;38;32;354;34.0;52722753
2022-07-04;106;115;473;68.0;52722859
2022-07-04;31;29;448;-75.0;52722890
2022-07-04;29;33;356;-2.0;52722919
2022-07-04;184;194;874;155.0;52723103
2022-07-04;19;20;287;-165.0;52723122
2022-07-04;36;42;21;17.0;52723158
2022-07-04;59;97;658;23.0;52723217
2022-07-04;148;179;749;89.0;52723365
2022-07-04;931;1111;6083;783.0;52724296
2022-07-04;26;36;4;-905.0;52724322
2022-07-04;88;116;823;62.0;52724410
2022-07-05;48;29;640;-40.0;52724458
2022-07-05;34;36;571;-14.0;52724492
2022-07-05;25;27;3;-9.0;52724517
2022-07-05;30;30;592;5.0;52724547
2022-07-05;43;62;442;13.0;52724590
2022-07-05;80;70;825;37.0;52724670
2022-07-05;36;53;24;-44.0;52724706
2022-07-05;77;93;920;41.0;52724783
2022-07-05;2;2;0;-75.0;52724785
2022-07-05;161;167;940;159.0;52724946
2022-07-05;47;33;489;-114.0;52724993
2022-07-05;765;774;7339;718.0;52725758
2022-07-05;94;87;720;-671.0;52725852
2022-07-05;55;65;809;-39.0;52725907
2022-07-05;33;20;364;-22.0;52725940
2022-07-06;67;84;853;34.0;52726007
2022-07-06;2;2;0;-65.0;52726009
2022-07-06;820;873;6217;818.0;52726829
2022-07-06;44;51;369;-776.0;52726873
2022-07-06;69;69;718;25.0;52726942
2022-07-06;38;24;458;-31.0;52726980
2022-07-06;24;16;290;-14.0;52727004
2022-07-06;82;96;745;58.0;52727086
2022-07-06;34;24;444;-48.0;52727120
2022-07-06;28;24;401;-6.0;52727148
2022-07-06;180;194;847;152.0;52727328
2022-07-06;40;62;7;-140.0;52727368
2022-07-06;72;84;602;32.0;52727440
2022-07-06;105;111;25;33.0;52727545
2022-07-06;35;32;458;-70.0;52727580
2022-07-07;1;3;1;-34.0;52727581
2022-07-07;17;21;5;16.0;52727598
2022-07-07;35;36;453;18.0;52727633
2022-07-07;768;750;6702;733.0;52728401
2022-07-07;34;29;507;-734.0;52728435
2022-07-07;164;163;874;130.0;52728599
2022-07-07;83;88;586;-81.0;52728682
2022-07-07;90;74;805;7.0;52728772
2022-07-07;26;37;24;-64.0;52728798
2022-07-07;31;30;592;5.0;52728829
2022-07-07;51;42;394;20.0;52728880
2022-07-07;48;34;563;-3.0;52728928
2022-07-07;74;70;805;26.0;52729002
2022-07-07;86;92;760;12.0;52729088
2022-07-07;28;31;333;-58.0;52729116
2022-07-08;58;67;19;30.0;52729174
2022-07-08;35;22;577;-23.0;52729209
2022-07-08;70;72;953;35.0;52729279
2022-07-08;29;28;6;-41.0;52729308
2022-07-08;1;2;0;-28.0;52729309
2022-07-08;88;110;727;87.0;52729397
2022-07-08;847;858;7755;759.0;52730244
2022-07-08;19;16;369;-828.0;52730263
2022-07-08;42;38;642;23.0;52730305
2022-07-08;41;51;461;-1.0;52730346
2022-07-08;83;78;996;42.0;52730429
2022-07-08;221;214;1001;138.0;52730650
2022-07-08;32;32;452;-189.0;52730682
2022-07-08;83;95;965;51.0;52730765
2022-07-08;45;33;587;-38.0;52730810
2022-07-09;37;40;471;-8.0;52730847
2022-07-09;30;29;220;-7.0;52730877
2022-07-09;36;46;356;6.0;52730913
2022-07-09;7;7;111;-29.0;52730920
2022-07-09;21;16;223;14.0;52730941
2022-07-09;0;0;0;-21.0;52730941
2022-07-09;37;34;375;37.0;52730978
2022-07-09;15;11;177;-22.0;52730993
2022-07-09;47;35;411;32.0;52731040
2022-07-09;33;30;0;-14.0;52731073
2022-07-09;82;109;437;49.0;52731155
2022-07-09;409;427;3083;327.0;52731564
2022-07-09;17;17;152;-392.0;52731581
2022-07-09;12;7;143;-5.0;52731593
2022-07-09;35;46;7;23.0;52731628
2022-07-10;3;2;33;-32.0;52731631
2022-07-10;13;13;96;10.0;52731644
2022-07-10;6;5;46;-7.0;52731650
2022-07-10;28;36;152;22.0;52731678
2022-07-10;16;49;169;-12.0;52731694
2022-07-10;5;7;40;-11.0;52731699
2022-07-10;8;3;0;3.0;52731707
2022-07-10;5;8;3;-3.0;52731712
2022-07-10;5;5;24;0.0;52731717
2022-07-10;6;23;96;1.0;52731723
2022-07-10;17;31;142;11.0;52731740
2022-07-10;14;28;141;-3.0;52731754
2022-07-10;0;0;0;-14.0;52731754
2022-07-10;6;3;23;6.0;52731760
2022-07-10;132;213;965;126.0;52731892
2022-07-11;1;1;0;-131.0;52731893
2022-07-11;50;48;654;49.0;52731943
2022-07-11;21;11;223;-29.0;52731964
2022-07-11;20;19;2;-1.0;52731984
2022-07-11;27;15;361;7.0;52732011
2022-07-11;32;20;420;5.0;52732043
2022-07-11;60;63;690;28.0;52732103
2022-07-11;140;125;730;80.0;52732243
2022-07-11;64;74;621;-76.0;52732307
2022-07-11;88;81;724;24.0;52732395
2022-07-11;33;22;402;-55.0;52732428
2022-07-11;30;46;16;-3.0;52732458
2022-07-11;38;26;390;8.0;52732496
2022-07-11;635;598;5647;597.0;52733131
2022-07-11;31;47;414;-604.0;52733162
2022-07-12;46;41;627;15.0;52733208
2022-07-12;42;29;577;-4.0;52733250
2022-07-12;22;15;3;-20.0;52733272
2022-07-12;141;149;866;119.0;52733413
2022-07-12;101;119;887;-40.0;52733514
2022-07-12;1;0;1;-100.0;52733515
2022-07-12;64;50;425;63.0;52733579
2022-07-12;76;79;859;12.0;52733655
2022-07-12;32;14;409;-44.0;52733687
2022-07-12;72;86;947;40.0;52733759
2022-07-12;76;75;715;4.0;52733835
2022-07-12;24;40;12;-52.0;52733859
2022-07-12;48;30;587;24.0;52733907
2022-07-12;794;772;7618;746.0;52734701
2022-07-12;49;45;703;-745.0;52734750
2022-07-13;85;68;657;36.0;52734835
2022-07-13;23;19;262;-62.0;52734858
2022-07-13;59;81;16;36.0;52734917
2022-07-13;2;0;0;-57.0;52734919
2022-07-13;36;18;369;34.0;52734955
2022-07-13;88;78;779;52.0;52735043
2022-07-13;133;171;691;45.0;52735176
2022-07-13;39;39;6;-94.0;52735215
2022-07-13;33;29;485;-6.0;52735248
2022-07-13;79;76;762;46.0;52735327
2022-07-13;62;51;381;-17.0;52735389
2022-07-13;783;741;5986;721.0;52736172
2022-07-13;38;23;442;-745.0;52736210
2022-07-13;68;62;698;30.0;52736278
2022-07-13;38;26;438;-30.0;52736316
2022-07-14;12;13;139;-26.0;52736328
2022-07-14;14;15;125;2.0;52736342
2022-07-14;7;6;83;-7.0;52736349
2022-07-14;0;1;31;-7.0;52736349
2022-07-14;2;4;1;2.0;52736351
2022-07-14;7;13;114;5.0;52736358
2022-07-14;2;2;14;-5.0;52736360
2022-07-14;1;0;0;-1.0;52736361
2022-07-14;19;15;107;18.0;52736380
2022-07-14;2;1;36;-17.0;52736382
2022-07-14;2;1;35;0.0;52736384
2022-07-14;4;4;5;2.0;52736388
2022-07-14;14;21;150;10.0;52736402
2022-07-14;91;97;877;77.0;52736493
2022-07-14;5;1;37;-86.0;52736498
2022-07-15;108;139;670;103.0;52736606
2022-07-15;15;15;228;-93.0;52736621
2022-07-15;661;671;5837;646.0;52737282
2022-07-15;37;21;334;-624.0;52737319
2022-07-15;18;41;20;-19.0;52737337
2022-07-15;56;61;733;38.0;52737393
2022-07-15;83;78;670;27.0;52737476
2022-07-15;67;67;838;-16.0;52737543
2022-07-15;19;24;6;-48.0;52737562
2022-07-15;29;18;357;10.0;52737591
2022-07-15;1;2;0;-28.0;52737592
2022-07-15;22;18;314;21.0;52737614
2022-07-15;35;31;421;13.0;52737649
2022-07-15;97;106;814;62.0;52737746
2022-07-15;74;50;432;-23.0;52737820
2022-07-16;53;76;340;-21.0;52737873
2022-07-16;5;4;105;-48.0;52737878
2022-07-16;0;0;0;-5.0;52737878
2022-07-16;24;26;348;24.0;52737902
2022-07-16;8;3;82;-16.0;52737910
2022-07-16;38;48;397;30.0;52737948
2022-07-16;8;7;131;-30.0;52737956
2022-07-16;10;9;135;2.0;52737966
2022-07-16;10;5;72;0.0;52737976
2022-07-16;27;27;194;17.0;52738003
2022-07-16;22;21;283;-5.0;52738025
2022-07-16;25;33;319;3.0;52738050
2022-07-16;248;300;2413;223.0;52738298
2022-07-16;9;28;6;-239.0;52738307
2022-07-16;9;13;1;0.0;52738316
2022-07-17;15;29;135;6.0;52738331
2022-07-17;14;20;91;-1.0;52738345
2022-07-17;0;0;0;-14.0;52738345
2022-07-17;4;5;3;4.0;52738349
2022-07-17;5;13;119;1.0;52738354
2022-07-17;83;111;754;78.0;52738437
2022-07-17;5;4;23;-78.0;52738442
2022-07-17;3;1;16;-2.0;52738445
2022-07-17;4;2;40;1.0;52738449
2022-07-17;4;6;90;0.0;52738453
2022-07-17;1;1;24;-3.0;52738454
2022-07-17;3;2;37;2.0;52738457
2022-07-17;4;2;0;1.0;52738461
2022-07-17;9;15;86;5.0;52738470
2022-07-17;12;11;90;3.0;52738482
2022-07-18;41;58;412;29.0;52738523
2022-07-18;49;59;587;8.0;52738572
2022-07-18;38;49;504;-11.0;52738610
2022-07-18;517;627;4697;479.0;52739127
2022-07-18;25;21;255;-492.0;52739152
2022-07-18;66;91;591;41.0;52739218
2022-07-18;34;27;360;-32.0;52739252
2022-07-18;96;124;595;62.0;52739348
2022-07-18;21;19;214;-75.0;52739369
2022-07-18;18;30;11;-3.0;52739387
2022-07-18;26;17;281;8.0;52739413
2022-07-18;18;12;161;-8.0;52739431
2022-07-18;0;1;1;-18.0;52739431
2022-07-18;69;102;722;69.0;52739500
2022-07-18;16;17;3;-53.0;52739516
2022-07-19;1;0;0;-15.0;52739517
2022-07-19;41;51;375;40.0;52739558
2022-07-19;77;80;666;36.0;52739635
2022-07-19;54;67;668;-23.0;52739689
2022-07-19;80;64;597;26.0;52739769
2022-07-19;28;25;390;-52.0;52739797
2022-07-19;22;19;270;-6.0;52739819
2022-07-19;37;29;503;15.0;52739856
2022-07-19;27;30;482;-10.0;52739883
2022-07-19;70;71;620;43.0;52739953
2022-07-19;621;627;5607;551.0;52740574
2022-07-19;19;19;1;-602.0;52740593
2022-07-19;32;19;408;13.0;52740625
2022-07-19;113;120;619;81.0;52740738
2022-07-19;20;33;8;-93.0;52740758
2022-07-20;656;642;4926;636.0;52741414
2022-07-20;43;41;376;-613.0;52741457
2022-07-20;26;22;220;-17.0;52741483
2022-07-20;45;58;532;19.0;52741528
2022-07-20;0;1;1;-45.0;52741528
2022-07-20;96;92;652;96.0;52741624
2022-07-20;37;21;393;-59.0;52741661
2022-07-20;32;30;387;-5.0;52741693
2022-07-20;81;78;572;49.0;52741774
2022-07-20;33;21;297;-48.0;52741807
2022-07-20;106;109;567;73.0;52741913
2022-07-20;29;29;3;-77.0;52741942
2022-07-20;37;46;18;8.0;52741979
2022-07-20;67;70;589;30.0;52742046
2022-07-20;24;24;319;-43.0;52742070
2022-07-21;536;619;4718;512.0;52742606
2022-07-21;24;22;265;-512.0;52742630
2022-07-21;30;42;324;6.0;52742660
2022-07-21;57;72;543;27.0;52742717
2022-07-21;1;0;1;-56.0;52742718
2022-07-21;47;65;566;46.0;52742765
2022-07-21;15;24;8;-32.0;52742780
2022-07-21;98;106;427;83.0;52742878
2022-07-21;72;94;583;-26.0;52742950
2022-07-21;26;25;401;-46.0;52742976
2022-07-21;23;20;395;-3.0;52742999
2022-07-21;32;34;352;9.0;52743031
2022-07-21;38;24;365;6.0;52743069
2022-07-21;6;12;4;-32.0;52743075
2022-07-21;67;79;484;61.0;52743142
2022-07-22;24;18;292;-43.0;52743166
2022-07-22;50;53;360;26.0;52743216
2022-07-22;29;24;247;-21.0;52743245
2022-07-22;81;112;744;52.0;52743326
2022-07-22;122;125;584;41.0;52743448
2022-07-22;34;26;407;-88.0;52743482
2022-07-22;639;680;5546;605.0;52744121
2022-07-22;79;73;581;-560.0;52744200
2022-07-22;55;66;733;-24.0;52744255
2022-07-22;31;18;454;-24.0;52744286
2022-07-22;25;33;392;-6.0;52744311
2022-07-22;14;16;7;-11.0;52744325
2022-07-22;2;2;0;-12.0;52744327
2022-07-22;78;75;726;76.0;52744405
2022-07-22;15;39;19;-63.0;52744420
2022-07-23;47;49;327;32.0;52744467
2022-07-23;8;9;143;-39.0;52744475
2022-07-23;7;11;108;-1.0;52744482
2022-07-23;19;29;1;12.0;52744501
2022-07-23;296;406;2288;277.0;52744797
2022-07-23;15;31;13;-281.0;52744812
2022-07-23;28;39;308;13.0;52744840
2022-07-23;6;7;96;-22.0;52744846
2022-07-23;37;43;295;31.0;52744883
2022-07-23;10;10;112;-27.0;52744893
2022-07-23;8;5;54;-2.0;52744901
2022-07-23;23;27;199;15.0;52744924
2022-07-23;41;58;328;18.0;52744965
2022-07-23;0;1;0;-41.0;52744965
2022-07-23;47;87;304;47.0;52745012
2022-07-24;12;13;69;-35.0;52745024
2022-07-24;3;1;21;-9.0;52745027
2022-07-24;0;0;0;-3.0;52745027
2022-07-24;1;1;10;1.0;52745028
2022-07-24;2;3;22;1.0;52745030
2022-07-24;3;4;5;1.0;52745033
2022-07-24;4;5;1;1.0;52745037
2022-07-24;6;4;15;2.0;52745043
2022-07-24;6;4;66;0.0;52745049
2022-07-24;85;86;568;79.0;52745134
2022-07-24;10;12;93;-75.0;52745144
2022-07-24;18;16;96;8.0;52745162
2022-07-24;11;12;75;-7.0;52745173
2022-07-24;1;1;16;-10.0;52745174
2022-07-24;8;10;79;7.0;52745182
2022-07-25;28;17;220;20.0;52745210
2022-07-25;13;12;3;-15.0;52745223
2022-07-25;20;21;249;7.0;52745243
2022-07-25;54;74;479;34.0;52745297
2022-07-25;55;54;438;1.0;52745352
2022-07-25;0;2;0;-55.0;52745352
2022-07-25;35;49;408;35.0;52745387
2022-07-25;59;74;499;24.0;52745446
2022-07-25;39;54;273;-20.0;52745485
2022-07-25;18;20;14;-21.0;52745503
2022-07-25;441;526;3508;423.0;52745944
2022-07-25;23;21;189;-418.0;52745967
2022-07-25;13;14;181;-10.0;52745980
2022-07-25;15;17;128;2.0;52745995
2022-07-25;69;97;427;54.0;52746064
2022-07-26;0;1;0;-69.0;52746064
2022-07-26;19;25;1;19.0;52746083
2022-07-26;68;60;579;49.0;52746151
2022-07-26;13;36;14;-55.0;52746164
2022-07-26;30;25;387;17.0;52746194
2022-07-26;57;71;601;27.0;52746251
2022-07-26;73;80;609;16.0;52746324
2022-07-26;43;43;305;-30.0;52746367
2022-07-26;27;26;411;-16.0;52746394
2022-07-26;18;7;247;-9.0;52746412
2022-07-26;40;23;392;22.0;52746452
2022-07-26;87;84;511;47.0;52746539
2022-07-26;25;36;370;-62.0;52746564
2022-07-26;560;574;4917;535.0;52747124
2022-07-26;60;57;490;-500.0;52747184
2022-07-27;68;72;516;8.0;52747252
2022-07-27;93;114;428;25.0;52747345
2022-07-27;2;1;0;-91.0;52747347
2022-07-27;23;43;5;21.0;52747370
2022-07-27;40;63;377;17.0;52747410
2022-07-27;31;56;18;-9.0;52747441
2022-07-27;24;13;197;-7.0;52747465
2022-07-27;22;29;326;-2.0;52747487
2022-07-27;25;22;263;3.0;52747512
2022-07-27;24;27;272;-1.0;52747536
2022-07-27;52;60;458;28.0;52747588
2022-07-27;46;39;255;-6.0;52747634
2022-07-27;17;20;241;-29.0;52747651
2022-07-27;44;45;446;27.0;52747695
2022-07-27;511;604;3802;467.0;52748206
2022-07-28;45;49;425;-466.0;52748251
2022-07-28;68;73;399;23.0;52748319
2022-07-28;32;25;273;-36.0;52748351
2022-07-28;35;33;291;3.0;52748386
2022-07-28;79;95;380;44.0;52748465
2022-07-28;13;19;11;-66.0;52748478
2022-07-28;14;10;169;1.0;52748492
2022-07-28;506;549;3682;492.0;52748998
2022-07-28;29;32;334;-477.0;52749027
2022-07-28;0;1;0;-29.0;52749027
2022-07-28;74;82;455;74.0;52749101
2022-07-28;46;54;408;-28.0;52749147
2022-07-28;25;24;291;-21.0;52749172
2022-07-28;12;12;2;-13.0;52749184
2022-07-28;34;40;244;22.0;52749218
2022-07-29;0;1;0;-34.0;52749218
2022-07-29;21;17;253;21.0;52749239
2022-07-29;22;22;283;1.0;52749261
2022-07-29;33;30;330;11.0;52749294
2022-07-29;56;51;320;23.0;52749350
2022-07-29;29;21;302;-27.0;52749379
2022-07-29;529;575;3970;500.0;52749908
2022-07-29;14;20;3;-515.0;52749922
2022-07-29;61;50;513;47.0;52749983
2022-07-29;13;23;19;-48.0;52749996
2022-07-29;64;56;452;51.0;52750060
2022-07-29;52;68;437;-12.0;52750112
2022-07-29;72;85;495;20.0;52750184
2022-07-29;77;113;402;5.0;52750261
2022-07-29;15;18;161;-62.0;52750276
2022-07-30;21;25;149;6.0;52750297
2022-07-30;20;22;135;-1.0;52750317
2022-07-30;6;4;51;-14.0;52750323
2022-07-30;24;31;172;18.0;52750347
2022-07-30;1;0;0;-23.0;52750348
2022-07-30;24;27;201;23.0;52750372
2022-07-30;28;42;148;4.0;52750400
2022-07-30;17;14;92;-11.0;52750417
2022-07-30;9;14;1;-8.0;52750426
2022-07-30;8;5;80;-1.0;52750434
2022-07-30;16;16;65;8.0;52750450
2022-07-30;18;28;7;2.0;52750468
2022-07-30;228;270;1338;210.0;52750696
2022-07-30;32;33;200;-196.0;52750728
2022-07-30;4;9;37;-28.0;52750732
2022-07-31;11;12;52;7.0;52750743
2022-07-31;4;2;17;-7.0;52750747
2022-07-31;5;8;32;1.0;52750752
2022-07-31;3;6;21;-2.0;52750755
2022-07-31;0;0;0;-3.0;52750755
2022-07-31;6;4;2;6.0;52750761
2022-07-31;13;15;50;7.0;52750774
2022-07-31;2;3;14;-11.0;52750776
2022-07-31;66;84;358;64.0;52750842
2022-07-31;4;12;42;-62.0;52750846
2022-07-31;2;3;0;-2.0;52750848
2022-07-31;2;1;6;0.0;52750850
2022-07-31;1;1;9;-1.0;52750851
2022-07-31;6;11;51;5.0;52750857
2022-07-31;7;6;62;1.0;52750864
2022-08-01;12;24;14;5.0;52750876
2022-08-01;4;8;124;-8.0;52750880
2022-08-01;0;0;2;-4.0;52750880
2022-08-01;99;114;516;99.0;52750979
2022-08-01;34;47;343;-65.0;52751013
2022-08-01;14;8;2;-20.0;52751027
2022-08-01;459;575;2915;445.0;52751486
2022-08-01;67;93;281;-392.0;52751553
2022-08-01;15;12;136;-52.0;52751568
2022-08-01;13;17;163;-2.0;52751581
2022-08-01;78;85;431;65.0;52751659
2022-08-01;9;7;89;-69.0;52751668
2022-08-01;51;78;324;42.0;52751719
2022-08-01;7;14;134;-44.0;52751726
2022-08-01;56;68;356;49.0;52751782
2022-08-02;1;0;0;-55.0;52751783
2022-08-02;12;14;3;11.0;52751795
2022-08-02;4;10;173;-8.0;52751799
2022-08-02;72;47;337;68.0;52751871
2022-08-02;46;51;378;-26.0;52751917
2022-08-02;17;20;206;-29.0;52751934
2022-08-02;24;20;263;7.0;52751958
2022-08-02;71;68;376;47.0;52752029
2022-08-02;35;42;307;-36.0;52752064
2022-08-02;64;90;287;29.0;52752128
2022-08-02;27;28;258;-37.0;52752155
2022-08-02;37;36;252;10.0;52752192
2022-08-02;13;11;11;-24.0;52752205
2022-08-02;21;25;239;8.0;52752226
2022-08-02;444;462;3090;423.0;52752670
2022-08-03;21;13;173;-423.0;52752691
2022-08-03;42;53;279;21.0;52752733
2022-08-03;1;0;0;-41.0;52752734
2022-08-03;13;13;2;12.0;52752747
2022-08-03;60;64;217;47.0;52752807
2022-08-03;33;40;187;-27.0;52752840
2022-08-03;65;52;299;32.0;52752905
2022-08-03;10;11;111;-55.0;52752915
2022-08-03;18;20;151;8.0;52752933
2022-08-03;18;11;144;0.0;52752951
2022-08-03;18;29;12;0.0;52752969
2022-08-03;14;19;157;-4.0;52752983
2022-08-03;41;36;248;27.0;52753024
2022-08-03;388;402;2264;347.0;52753412
2022-08-03;34;41;284;-354.0;52753446
2022-08-04;8;14;168;-26.0;52753454
2022-08-04;7;17;5;-1.0;52753461
2022-08-04;3;3;2;-4.0;52753464
2022-08-04;46;40;273;43.0;52753510
2022-08-04;324;377;2387;278.0;52753834
2022-08-04;54;59;305;-270.0;52753888
2022-08-04;45;52;259;-9.0;52753933
2022-08-04;36;56;188;-9.0;52753969
2022-08-04;30;31;185;-6.0;52753999
2022-08-04;18;10;133;-12.0;52754017
2022-08-04;19;18;183;1.0;52754036
2022-08-04;11;13;195;-8.0;52754047
2022-08-04;18;27;194;7.0;52754065
2022-08-04;28;37;297;10.0;52754093
2022-08-04;1;0;0;-27.0;52754094
2022-08-05;37;41;336;36.0;52754131
2022-08-05;24;14;193;-13.0;52754155
2022-08-05;26;19;198;2.0;52754181
2022-08-05;47;72;201;21.0;52754228
2022-08-05;0;0;1;-47.0;52754228
2022-08-05;42;46;290;42.0;52754270
2022-08-05;54;58;334;12.0;52754324
2022-08-05;9;12;134;-45.0;52754333
2022-08-05;16;17;12;7.0;52754349
2022-08-05;26;25;236;10.0;52754375
2022-08-05;35;60;300;9.0;52754410
2022-08-05;29;29;199;-6.0;52754439
2022-08-05;6;6;1;-23.0;52754445
2022-08-05;368;417;2594;362.0;52754813
2022-08-05;17;18;159;-351.0;52754830
2022-08-06;18;20;92;1.0;52754848
2022-08-06;23;13;112;5.0;52754871
2022-08-06;152;176;861;129.0;52755023
2022-08-06;2;6;31;-150.0;52755025
2022-08-06;4;8;43;2.0;52755029
2022-08-06;5;5;45;1.0;52755034
2022-08-06;16;21;106;11.0;52755050
2022-08-06;8;14;5;-8.0;52755058
2022-08-06;4;5;0;-4.0;52755062
2022-08-06;0;0;1;-4.0;52755062
2022-08-06;20;22;61;20.0;52755082
2022-08-06;9;12;57;-11.0;52755091
2022-08-06;8;5;51;-1.0;52755099
2022-08-06;6;15;111;-2.0;52755105
2022-08-06;29;30;146;23.0;52755134
2022-08-07;4;6;24;-25.0;52755138
2022-08-07;0;0;9;-4.0;52755138
2022-08-07;2;0;10;2.0;52755140
2022-08-07;5;11;22;3.0;52755145
2022-08-07;16;10;41;11.0;52755161
2022-08-07;1;3;11;-15.0;52755162
2022-08-07;1;0;0;0.0;52755163
2022-08-07;3;2;10;2.0;52755166
2022-08-07;10;8;22;7.0;52755176
2022-08-07;3;5;22;-7.0;52755179
2022-08-07;6;4;44;3.0;52755185
2022-08-07;2;1;4;-4.0;52755187
2022-08-07;53;51;219;51.0;52755240
2022-08-07;0;1;0;-53.0;52755240
2022-08-07;0;0;0;0.0;52755240
2022-08-08;11;9;96;11.0;52755251
2022-08-08;9;11;78;-2.0;52755260
2022-08-08;9;14;1;0.0;52755269
2022-08-08;6;4;6;-3.0;52755275
2022-08-08;9;9;59;3.0;52755284
2022-08-08;38;56;131;29.0;52755322
2022-08-08;50;75;200;12.0;52755372
2022-08-08;316;423;1446;266.0;52755688
2022-08-08;11;9;84;-305.0;52755699
2022-08-08;2;1;0;-9.0;52755701
2022-08-08;25;33;177;23.0;52755726
2022-08-08;16;14;99;-9.0;52755742
2022-08-08;33;52;125;17.0;52755775
2022-08-08;70;88;212;37.0;52755845
2022-08-08;27;48;178;-43.0;52755872
2022-08-09;48;54;187;21.0;52755920
2022-08-09;27;34;273;-21.0;52755947
2022-08-09;10;14;172;-17.0;52755957
2022-08-09;17;18;159;7.0;52755974
2022-08-09;0;0;0;-17.0;52755974
2022-08-09;11;7;95;11.0;52755985
2022-08-09;29;34;145;18.0;52756014
2022-08-09;47;52;261;18.0;52756061
2022-08-09;19;19;214;-28.0;52756080
2022-08-09;13;17;160;-6.0;52756093
2022-08-09;7;12;0;-6.0;52756100
2022-08-09;11;17;8;4.0;52756111
2022-08-09;48;42;244;37.0;52756159
2022-08-09;330;367;2147;282.0;52756489
2022-08-09;43;47;229;-287.0;52756532
2022-08-10;35;61;136;-8.0;52756567
2022-08-10;6;10;76;-29.0;52756573
2022-08-10;12;25;6;6.0;52756585
2022-08-10;291;450;1715;279.0;52756876
2022-08-10;10;12;150;-281.0;52756886
2022-08-10;14;13;2;4.0;52756900
2022-08-10;0;0;0;-14.0;52756900
2022-08-10;12;13;124;12.0;52756912
2022-08-10;35;54;183;23.0;52756947
2022-08-10;8;17;118;-27.0;52756955
2022-08-10;55;90;221;47.0;52757010
2022-08-10;40;64;201;-15.0;52757050
2022-08-10;16;15;118;-24.0;52757066
2022-08-10;31;30;214;15.0;52757097
2022-08-10;17;46;166;-14.0;52757114
2022-08-11;1;3;1;-16.0;52757115
2022-08-11;5;16;2;4.0;52757120
2022-08-11;264;330;1614;259.0;52757384
2022-08-11;5;14;7;-259.0;52757389
2022-08-11;15;22;113;10.0;52757404
2022-08-11;25;21;124;10.0;52757429
2022-08-11;23;32;213;-2.0;52757452
2022-08-11;34;32;188;11.0;52757486
2022-08-11;43;50;201;9.0;52757529
2022-08-11;35;39;109;-8.0;52757564
2022-08-11;36;50;171;1.0;52757600
2022-08-11;10;15;79;-26.0;52757610
2022-08-11;10;9;146;0.0;52757620
2022-08-11;11;12;117;1.0;52757631
2022-08-11;11;15;143;0.0;52757642
2022-08-12;27;33;215;16.0;52757669
2022-08-12;41;31;144;14.0;52757710
2022-08-12;13;7;113;-28.0;52757723
2022-08-12;56;54;145;43.0;52757779
2022-08-12;67;61;205;11.0;52757846
2022-08-12;15;19;127;-52.0;52757861
2022-08-12;73;56;215;58.0;52757934
2022-08-12;14;13;114;-59.0;52757948
2022-08-12;8;10;86;-6.0;52757956
2022-08-12;389;353;1749;381.0;52758345
2022-08-12;17;10;157;-372.0;52758362
2022-08-12;0;1;0;-17.0;52758362
2022-08-12;7;10;1;7.0;52758369
2022-08-12;41;34;219;34.0;52758410
2022-08-12;10;14;8;-31.0;52758420
2022-08-13;2;0;0;-8.0;52758422
2022-08-13;3;4;22;1.0;52758425
2022-08-13;168;152;508;165.0;52758593
2022-08-13;40;25;80;-128.0;52758633
2022-08-13;12;18;50;-28.0;52758645
2022-08-13;19;9;62;7.0;52758664
2022-08-13;5;7;6;-14.0;52758669
2022-08-13;7;7;1;2.0;52758676
2022-08-13;13;12;53;6.0;52758689
2022-08-13;0;3;17;-13.0;52758689
2022-08-13;1;2;12;1.0;52758690
2022-08-13;3;2;23;2.0;52758693
2022-08-13;32;29;65;29.0;52758725
2022-08-13;24;23;75;-8.0;52758749
2022-08-13;7;11;42;-17.0;52758756
2022-08-14;1;3;5;-6.0;52758757
2022-08-14;4;4;17;3.0;52758761
2022-08-14;10;8;17;6.0;52758771
2022-08-14;0;0;3;-10.0;52758771
2022-08-14;5;8;13;5.0;52758776
2022-08-14;0;0;0;-5.0;52758776
2022-08-14;5;11;16;5.0;52758781
2022-08-14;0;0;5;-5.0;52758781
2022-08-14;0;0;5;0.0;52758781
2022-08-14;1;4;12;1.0;52758782
2022-08-14;3;0;9;2.0;52758785
2022-08-14;1;1;0;-2.0;52758786
2022-08-14;0;2;0;-1.0;52758786
2022-08-14;7;8;11;7.0;52758793
2022-08-14;37;49;113;30.0;52758830
2022-08-15;0;0;2;-37.0;52758830
2022-08-15;12;15;38;12.0;52758842
2022-08-15;12;22;68;0.0;52758854
2022-08-15;10;18;50;-2.0;52758864
2022-08-15;0;0;0;-10.0;52758864
2022-08-15;0;0;2;0.0;52758864
2022-08-15;0;2;7;0.0;52758864
2022-08-15;0;2;7;0.0;52758864
2022-08-15;10;15;42;10.0;52758874
2022-08-15;1;0;2;-9.0;52758875
2022-08-15;7;2;24;6.0;52758882
2022-08-15;0;4;2;-7.0;52758882
2022-08-15;63;89;262;63.0;52758945
2022-08-15;4;2;9;-59.0;52758949
2022-08-15;7;7;9;3.0;52758956
2022-08-16;280;361;1465;273.0;52759236
2022-08-16;8;14;106;-272.0;52759244
2022-08-16;27;34;130;19.0;52759271
2022-08-16;10;15;94;-17.0;52759281
2022-08-16;43;45;207;33.0;52759324
2022-08-16;13;17;96;-30.0;52759337
2022-08-16;23;41;148;10.0;52759360
2022-08-16;24;31;171;1.0;52759384
2022-08-16;51;64;207;27.0;52759435
2022-08-16;10;7;3;-41.0;52759445
2022-08-16;11;8;68;1.0;52759456
2022-08-16;10;14;95;-1.0;52759466
2022-08-16;13;12;9;3.0;52759479
2022-08-16;36;58;130;23.0;52759515
2022-08-16;1;1;1;-35.0;52759516
2022-08-17;2;1;1;1.0;52759518
2022-08-17;296;355;1483;294.0;52759814
2022-08-17;16;18;1;-280.0;52759830
2022-08-17;9;14;112;-7.0;52759839
2022-08-17;22;35;152;13.0;52759861
2022-08-17;26;24;117;4.0;52759887
2022-08-17;40;43;128;14.0;52759927
2022-08-17;43;41;163;3.0;52759970
2022-08-17;9;15;88;-34.0;52759979
2022-08-17;13;31;9;4.0;52759992
2022-08-17;25;29;196;12.0;52760017
2022-08-17;43;55;196;18.0;52760060
2022-08-17;6;7;57;-37.0;52760066
2022-08-17;13;12;93;7.0;52760079
2022-08-17;29;30;170;16.0;52760108
2022-08-18;253;349;1443;224.0;52760361
2022-08-18;0;0;0;-253.0;52760361
2022-08-18;11;14;129;11.0;52760372
2022-08-18;13;15;110;2.0;52760385
2022-08-18;8;10;1;-5.0;52760393
2022-08-18;23;44;137;15.0;52760416
2022-08-18;8;9;11;-15.0;52760424
2022-08-18;12;6;98;4.0;52760436
2022-08-18;34;46;177;22.0;52760470
2022-08-18;38;56;195;4.0;52760508
2022-08-18;9;10;58;-29.0;52760517
2022-08-18;12;13;103;3.0;52760529
2022-08-18;17;27;156;5.0;52760546
2022-08-18;34;50;156;17.0;52760580
2022-08-18;34;49;112;0.0;52760614
2022-08-19;8;6;8;-26.0;52760622
2022-08-19;33;52;141;25.0;52760655
2022-08-19;6;16;0;-27.0;52760661
2022-08-19;9;16;104;3.0;52760670
2022-08-19;12;10;66;3.0;52760682
2022-08-19;15;17;119;3.0;52760697
2022-08-19;9;20;129;-6.0;52760706
2022-08-19;40;49;264;31.0;52760746
2022-08-19;261;372;1615;221.0;52761007
2022-08-19;28;34;175;-233.0;52761035
2022-08-19;1;2;0;-27.0;52761036
2022-08-19;32;51;139;31.0;52761068
2022-08-19;33;55;176;1.0;52761101
2022-08-19;10;11;83;-23.0;52761111
2022-08-19;25;33;211;15.0;52761136
2022-08-20;11;8;4;-14.0;52761147
2022-08-20;0;3;27;-11.0;52761147
2022-08-20;25;27;63;25.0;52761172
2022-08-20;28;37;90;3.0;52761200
2022-08-20;0;1;0;-28.0;52761200
2022-08-20;0;1;12;0.0;52761200
2022-08-20;1;5;23;1.0;52761201
2022-08-20;23;27;58;22.0;52761224
2022-08-20;4;13;1;-19.0;52761228
2022-08-20;139;203;515;135.0;52761367
2022-08-20;17;30;55;-122.0;52761384
2022-08-20;4;7;28;-13.0;52761388
2022-08-20;12;20;56;8.0;52761400
2022-08-20;11;17;64;-1.0;52761411
2022-08-20;3;7;34;-8.0;52761414
2022-08-21;5;0;15;2.0;52761419
2022-08-21;4;6;17;-1.0;52761423
2022-08-21;0;1;6;-4.0;52761423
2022-08-21;1;1;2;1.0;52761424
2022-08-21;8;9;23;7.0;52761432
2022-08-21;3;1;0;-5.0;52761435
2022-08-21;1;1;7;-2.0;52761436
2022-08-21;7;5;21;6.0;52761443
2022-08-21;0;0;0;-7.0;52761443
2022-08-21;4;5;14;4.0;52761447
2022-08-21;0;1;1;-4.0;52761447
2022-08-21;6;3;14;6.0;52761453
2022-08-21;41;33;127;35.0;52761494
2022-08-21;1;0;3;-40.0;52761495
2022-08-21;1;0;4;0.0;52761496
2022-08-22;8;14;7;7.0;52761504
2022-08-22;11;14;1;3.0;52761515
2022-08-22;24;28;142;13.0;52761539
2022-08-22;28;59;156;4.0;52761567
2022-08-22;2;1;40;-26.0;52761569
2022-08-22;2;0;1;0.0;52761571
2022-08-22;32;47;112;30.0;52761603
2022-08-22;6;5;42;-26.0;52761609
2022-08-22;4;10;59;-2.0;52761613
2022-08-22;24;34;147;20.0;52761637
2022-08-22;8;18;77;-16.0;52761645
2022-08-22;21;30;126;13.0;52761666
2022-08-22;221;320;1204;200.0;52761887
2022-08-22;36;47;203;-185.0;52761923
2022-08-22;15;13;91;-21.0;52761938
2022-08-23;290;332;1533;275.0;52762228
2022-08-23;54;53;191;-236.0;52762282
2022-08-23;60;55;135;6.0;52762342
2022-08-23;25;31;194;-35.0;52762367
2022-08-23;27;50;183;2.0;52762394
2022-08-23;29;39;150;2.0;52762423
2022-08-23;7;13;88;-22.0;52762430
2022-08-23;0;0;0;-7.0;52762430
2022-08-23;11;15;127;11.0;52762441
2022-08-23;24;32;109;13.0;52762465
2022-08-23;7;6;7;-17.0;52762472
2022-08-23;14;8;131;7.0;52762486
2022-08-23;10;8;0;-4.0;52762496
2022-08-23;14;16;139;4.0;52762510
2022-08-23;8;6;79;-6.0;52762518
2022-08-24;23;30;129;15.0;52762541
2022-08-24;11;11;106;-12.0;52762552
2022-08-24;47;56;178;36.0;52762599
2022-08-24;4;10;62;-43.0;52762603
2022-08-24;28;34;163;24.0;52762631
2022-08-24;4;0;0;-24.0;52762635
2022-08-24;2;6;58;-2.0;52762637
2022-08-24;10;13;0;8.0;52762647
2022-08-24;8;8;73;-2.0;52762655
2022-08-24;10;10;85;2.0;52762665
2022-08-24;20;28;14;10.0;52762685
2022-08-24;27;39;110;7.0;52762712
2022-08-24;37;42;143;10.0;52762749
2022-08-24;43;62;115;6.0;52762792
2022-08-24;274;349;1236;231.0;52763066
2022-08-25;12;16;80;-262.0;52763078
2022-08-25;18;17;110;6.0;52763096
2022-08-25;11;12;117;-7.0;52763107
2022-08-25;34;43;182;23.0;52763141
2022-08-25;39;45;117;5.0;52763180
2022-08-25;7;9;15;-32.0;52763187
2022-08-25;8;5;68;1.0;52763195
2022-08-25;9;10;93;1.0;52763204
2022-08-25;258;314;1391;249.0;52763462
2022-08-25;24;31;184;-234.0;52763486
2022-08-25;1;1;0;-23.0;52763487
2022-08-25;30;47;144;29.0;52763517
2022-08-25;9;12;1;-21.0;52763526
2022-08-25;23;30;113;14.0;52763549
2022-08-25;33;36;167;10.0;52763582
2022-08-26;20;27;114;-13.0;52763602
2022-08-26;9;8;111;-11.0;52763611
2022-08-26;29;38;136;20.0;52763640
2022-08-26;53;63;172;24.0;52763693
2022-08-26;46;38;181;-7.0;52763739
2022-08-26;55;40;157;9.0;52763794
2022-08-26;4;8;69;-51.0;52763798
2022-08-26;71;74;192;67.0;52763869
2022-08-26;15;32;22;-56.0;52763884
2022-08-26;15;15;105;0.0;52763899
2022-08-26;1;0;2;-14.0;52763900
2022-08-26;371;395;1531;370.0;52764271
2022-08-26;37;35;194;-334.0;52764308
2022-08-26;7;8;75;-30.0;52764315
2022-08-26;9;9;1;2.0;52764324
2022-08-27;6;13;46;-3.0;52764330
2022-08-27;12;15;7;6.0;52764342
2022-08-27;1;2;17;-11.0;52764343
2022-08-27;11;25;78;10.0;52764354
2022-08-27;0;0;0;-11.0;52764354
2022-08-27;8;13;68;8.0;52764362
2022-08-27;28;23;66;20.0;52764390
2022-08-27;118;153;546;90.0;52764508
2022-08-27;1;5;33;-117.0;52764509
2022-08-27;17;15;70;16.0;52764526
2022-08-27;5;1;27;-12.0;52764531
2022-08-27;4;3;21;-1.0;52764535
2022-08-27;17;25;89;13.0;52764552
2022-08-27;4;11;1;-13.0;52764556
2022-08-27;4;2;23;0.0;52764560
2022-08-28;7;10;19;3.0;52764567
2022-08-28;0;0;5;-7.0;52764567
2022-08-28;2;6;0;2.0;52764569
2022-08-28;0;0;0;-2.0;52764569
2022-08-28;3;3;5;3.0;52764572
2022-08-28;5;1;11;2.0;52764577
2022-08-28;59;60;119;54.0;52764636
2022-08-28;8;11;15;-51.0;52764644
2022-08-28;6;6;18;-2.0;52764650
2022-08-28;0;0;6;-6.0;52764650
2022-08-28;16;13;16;16.0;52764666
2022-08-28;1;1;2;-15.0;52764667
2022-08-28;4;0;0;3.0;52764671
2022-08-28;7;9;20;3.0;52764678
2022-08-28;0;0;2;-7.0;52764678
2022-08-29;7;6;55;7.0;52764685
2022-08-29;55;55;165;48.0;52764740
2022-08-29;53;51;153;-2.0;52764793
2022-08-29;293;326;1108;240.0;52765086
2022-08-29;13;21;124;-280.0;52765099
2022-08-29;9;12;1;-4.0;52765108
2022-08-29;42;53;155;33.0;52765150
2022-08-29;0;0;0;-42.0;52765150
2022-08-29;9;15;68;9.0;52765159
2022-08-29;34;32;131;25.0;52765193
2022-08-29;29;29;11;-5.0;52765222
2022-08-29;9;12;65;-20.0;52765231
2022-08-29;23;26;89;14.0;52765254
2022-08-29;7;8;56;-16.0;52765261
2022-08-29;3;6;35;-4.0;52765264
2022-08-30;19;18;123;16.0;52765283
2022-08-30;52;68;222;33.0;52765335
2022-08-30;20;23;14;-32.0;52765355
2022-08-30;0;0;0;-20.0;52765355
2022-08-30;9;15;109;9.0;52765364
2022-08-30;75;68;162;66.0;52765439
2022-08-30;49;49;158;-26.0;52765488
2022-08-30;11;8;0;-38.0;52765499
2022-08-30;27;21;139;16.0;52765526
2022-08-30;347;377;1605;320.0;52765873
2022-08-30;17;26;190;-330.0;52765890
2022-08-30;32;47;207;15.0;52765922
2022-08-30;11;7;70;-21.0;52765933
2022-08-30;14;15;109;3.0;52765947
2022-08-30;11;12;102;-3.0;52765958
2022-08-31;259;293;1068;248.0;52766217
2022-08-31;18;19;101;-241.0;52766235
2022-08-31;9;8;50;-9.0;52766244
2022-08-31;30;46;141;21.0;52766274
2022-08-31;16;17;3;-14.0;52766290
2022-08-31;8;11;70;-8.0;52766298
2022-08-31;10;12;75;2.0;52766308
2022-08-31;0;0;0;-10.0;52766308
2022-08-31;6;4;54;6.0;52766314
2022-08-31;9;12;69;3.0;52766323
2022-08-31;16;19;15;7.0;52766339
2022-08-31;28;28;128;12.0;52766367
2022-08-31;51;58;101;23.0;52766418
2022-08-31;41;43;121;-10.0;52766459
2022-08-31;17;16;140;-24.0;52766476
2022-09-01;21;22;203;4.0;52766497
2022-09-01;0;0;0;-21.0;52766497
2022-09-01;3;3;0;3.0;52766500
2022-09-01;33;40;147;30.0;52766533
2022-09-01;5;4;94;-28.0;52766538
2022-09-01;18;12;109;13.0;52766556
2022-09-01;34;34;109;16.0;52766590
2022-09-01;51;49;222;17.0;52766641
2022-09-01;5;8;6;-46.0;52766646
2022-09-01;41;43;209;36.0;52766687
2022-09-01;301;292;1633;260.0;52766988
2022-09-01;59;42;291;-242.0;52767047
2022-09-01;11;13;91;-48.0;52767058
2022-09-01;16;16;94;5.0;52767074
2022-09-01;4;6;58;-12.0;52767078
2022-09-02;52;54;143;48.0;52767130
2022-09-02;37;37;236;-15.0;52767167
2022-09-02;6;7;108;-31.0;52767173
2022-09-02;44;36;147;38.0;52767217
2022-09-02;5;3;81;-39.0;52767222
2022-09-02;11;9;93;6.0;52767233
2022-09-02;27;42;223;16.0;52767260
2022-09-02;14;21;155;-13.0;52767274
2022-09-02;68;54;267;54.0;52767342
2022-09-02;10;15;10;-58.0;52767352
2022-09-02;72;41;174;62.0;52767424
2022-09-02;12;15;127;-60.0;52767436
2022-09-02;372;342;1769;360.0;52767808
2022-09-02;0;0;0;-372.0;52767808
2022-09-02;14;8;5;14.0;52767822
2022-09-03;11;10;90;-3.0;52767833
2022-09-03;165;188;704;154.0;52767998
2022-09-03;5;5;35;-160.0;52768003
2022-09-03;0;0;0;-5.0;52768003
2022-09-03;11;19;95;11.0;52768014
2022-09-03;1;1;14;-10.0;52768015
2022-09-03;22;27;128;21.0;52768037
2022-09-03;4;2;32;-18.0;52768041
2022-09-03;21;22;80;17.0;52768062
2022-09-03;28;41;100;7.0;52768090
2022-09-03;22;17;1;-6.0;52768112
2022-09-03;16;16;15;-6.0;52768128
2022-09-03;5;3;31;-11.0;52768133
2022-09-03;4;5;15;-1.0;52768137
2022-09-03;15;20;68;11.0;52768152
2022-09-04;11;7;14;-4.0;52768163
2022-09-04;7;3;15;-4.0;52768170
2022-09-04;6;7;32;-1.0;52768176
2022-09-04;5;4;1;-1.0;52768181
2022-09-04;2;0;2;-3.0;52768183
2022-09-04;6;3;19;4.0;52768189
2022-09-04;0;0;0;-6.0;52768189
2022-09-04;1;1;1;1.0;52768190
2022-09-04;3;3;6;2.0;52768193
2022-09-04;0;0;3;-3.0;52768193
2022-09-04;1;0;5;1.0;52768194
2022-09-04;7;2;17;6.0;52768201
2022-09-04;5;6;13;-2.0;52768206
2022-09-04;2;0;6;-3.0;52768208
2022-09-04;56;36;134;54.0;52768264
2022-09-05;50;36;152;-6.0;52768314
2022-09-05;17;25;61;-33.0;52768331
2022-09-05;2;2;3;-15.0;52768333
2022-09-05;12;11;49;10.0;52768345
2022-09-05;32;42;106;20.0;52768377
2022-09-05;11;10;82;-21.0;52768388
2022-09-05;6;5;6;-5.0;52768394
2022-09-05;60;89;206;54.0;52768454
2022-09-05;27;23;140;-33.0;52768481
2022-09-05;2;6;52;-25.0;52768483
2022-09-05;102;72;153;100.0;52768585
2022-09-05;11;5;70;-91.0;52768596
2022-09-05;338;333;1116;327.0;52768934
2022-09-05;5;7;36;-333.0;52768939
2022-09-05;1;0;0;-4.0;52768940
2022-09-06;7;4;4;6.0;52768947
2022-09-06;51;44;202;44.0;52768998
2022-09-06;22;26;215;-29.0;52769020
2022-09-06;0;0;0;-22.0;52769020
2022-09-06;61;53;212;61.0;52769081
2022-09-06;390;271;1609;329.0;52769471
2022-09-06;11;9;2;-379.0;52769482
2022-09-06;109;37;164;98.0;52769591
2022-09-06;24;12;151;-85.0;52769615
2022-09-06;14;13;130;-10.0;52769629
2022-09-06;31;22;81;17.0;52769660
2022-09-06;7;10;102;-24.0;52769667
2022-09-06;4;4;72;-3.0;52769671
2022-09-06;14;11;131;10.0;52769685
2022-09-06;35;26;143;21.0;52769720
2022-09-07;38;26;146;3.0;52769758
2022-09-07;24;26;11;-14.0;52769782
2022-09-07;43;26;80;19.0;52769825
2022-09-07;4;6;39;-39.0;52769829
2022-09-07;47;29;105;43.0;52769876
2022-09-07;0;0;0;-47.0;52769876
2022-09-07;35;30;128;35.0;52769911
2022-09-07;7;7;71;-28.0;52769918
2022-09-07;25;22;84;18.0;52769943
2022-09-07;25;18;1;0.0;52769968
2022-09-07;10;6;94;-15.0;52769978
2022-09-07;6;10;77;-4.0;52769984
2022-09-07;11;8;44;5.0;52769995
2022-09-07;23;18;106;12.0;52770018
2022-09-07;298;232;986;275.0;52770316
2022-09-08;58;36;125;-240.0;52770374
2022-09-08;26;31;188;-32.0;52770400
2022-09-08;6;7;99;-20.0;52770406
2022-09-08;7;2;1;1.0;52770413
2022-09-08;13;11;87;6.0;52770426
2022-09-08;20;21;78;7.0;52770446
2022-09-08;31;29;156;11.0;52770477
2022-09-08;50;50;208;19.0;52770527
2022-09-08;32;31;91;-18.0;52770559
2022-09-08;13;9;114;-19.0;52770572
2022-09-08;8;9;50;-5.0;52770580
2022-09-08;279;253;1299;271.0;52770859
2022-09-08;8;12;96;-271.0;52770867
2022-09-08;7;5;6;-1.0;52770874
2022-09-08;0;0;0;-7.0;52770874
2022-09-09;53;42;116;53.0;52770927
2022-09-09;19;12;117;-34.0;52770946
2022-09-09;33;24;203;14.0;52770979
2022-09-09;17;10;100;-16.0;52770996
2022-09-09;19;11;6;2.0;52771015
2022-09-09;340;270;1487;321.0;52771355
2022-09-09;12;14;132;-328.0;52771367
2022-09-09;24;25;110;12.0;52771391
2022-09-09;39;41;193;15.0;52771430
2022-09-09;6;6;120;-33.0;52771436
2022-09-09;10;6;62;4.0;52771446
2022-09-09;10;5;4;0.0;52771456
2022-09-09;55;47;187;45.0;52771511
2022-09-09;0;0;0;-55.0;52771511
2022-09-09;43;27;137;43.0;52771554
2022-09-10;3;4;23;-40.0;52771557
2022-09-10;33;43;119;30.0;52771590
2022-09-10;11;9;64;-22.0;52771601
2022-09-10;4;4;25;-7.0;52771605
2022-09-10;16;18;11;12.0;52771621
2022-09-10;4;1;23;-12.0;52771625
2022-09-10;166;209;629;162.0;52771791
2022-09-10;8;28;62;-158.0;52771799
2022-09-10;10;8;34;2.0;52771809
2022-09-10;1;0;0;-9.0;52771810
2022-09-10;24;26;84;23.0;52771834
2022-09-10;3;4;18;-21.0;52771837
2022-09-10;7;18;1;4.0;52771844
2022-09-10;23;24;83;16.0;52771867
2022-09-10;19;22;82;-4.0;52771886
2022-09-11;3;5;8;-16.0;52771889
2022-09-11;2;2;2;-1.0;52771891
2022-09-11;14;5;35;12.0;52771905
2022-09-11;12;9;16;-2.0;52771917
2022-09-11;10;6;17;-2.0;52771927
2022-09-11;6;2;13;-4.0;52771933
2022-09-11;0;0;2;-6.0;52771933
2022-09-11;8;7;21;8.0;52771941
2022-09-11;1;2;0;-7.0;52771942
2022-09-11;0;0;3;-1.0;52771942
2022-09-11;1;0;2;1.0;52771943
2022-09-11;0;0;0;-1.0;52771943
2022-09-11;1;1;4;1.0;52771944
2022-09-11;0;1;11;-1.0;52771944
2022-09-11;58;40;134;58.0;52772002
2022-09-12;17;24;143;-41.0;52772019
2022-09-12;5;2;39;-12.0;52772024
2022-09-12;218;199;974;213.0;52772242
2022-09-12;5;7;56;-213.0;52772247
2022-09-12;24;31;146;19.0;52772271
2022-09-12;8;4;72;-16.0;52772279
2022-09-12;43;34;114;35.0;52772322
2022-09-12;4;3;30;-39.0;52772326
2022-09-12;9;9;58;5.0;52772335
2022-09-12;1;2;0;-8.0;52772336
2022-09-12;0;2;6;-1.0;52772336
2022-09-12;24;17;57;24.0;52772360
2022-09-12;47;41;152;23.0;52772407
2022-09-12;29;23;98;-18.0;52772436
2022-09-12;2;0;3;-27.0;52772438
2022-09-13;44;46;139;42.0;52772482
2022-09-13;7;2;4;-37.0;52772489
2022-09-13;12;8;127;5.0;52772501
2022-09-13;267;226;1516;255.0;52772768
2022-09-13;51;34;216;-216.0;52772819
2022-09-13;30;27;116;-21.0;52772849
2022-09-13;27;32;80;-3.0;52772876
2022-09-13;20;20;184;-7.0;52772896
2022-09-13;2;1;0;-18.0;52772898
2022-09-13;10;6;137;8.0;52772908
2022-09-13;12;7;116;2.0;52772920
2022-09-13;17;14;137;5.0;52772937
2022-09-13;4;1;2;-13.0;52772941
2022-09-13;8;4;79;4.0;52772949
2022-09-13;23;24;179;15.0;52772972
2022-09-14;18;20;13;-5.0;52772990
2022-09-14;56;49;89;38.0;52773046
2022-09-14;0;1;0;-56.0;52773046
2022-09-14;13;4;62;13.0;52773059
2022-09-14;26;25;119;13.0;52773085
2022-09-14;15;12;1;-11.0;52773100
2022-09-14;7;9;76;-8.0;52773107
2022-09-14;26;23;106;19.0;52773133
2022-09-14;59;36;151;33.0;52773192
2022-09-14;5;7;65;-54.0;52773197
2022-09-14;17;14;75;12.0;52773214
2022-09-14;298;251;1034;281.0;52773512
2022-09-14;13;19;115;-285.0;52773525
2022-09-14;37;29;120;24.0;52773562
2022-09-14;6;3;42;-31.0;52773568
2022-09-15;22;30;153;16.0;52773590
2022-09-15;6;10;5;-16.0;52773596
2022-09-15;41;41;173;35.0;52773637
2022-09-15;19;9;89;-22.0;52773656
2022-09-15;245;267;1254;226.0;52773901
2022-09-15;4;0;0;-241.0;52773905
2022-09-15;25;31;72;21.0;52773930
2022-09-15;10;9;101;-15.0;52773940
2022-09-15;28;29;92;18.0;52773968
2022-09-15;7;6;124;-21.0;52773975
2022-09-15;33;34;151;26.0;52774008
2022-09-15;33;55;133;0.0;52774041
2022-09-15;8;9;97;-25.0;52774049
2022-09-15;9;3;64;1.0;52774058
2022-09-15;0;1;0;-9.0;52774058
2022-09-16;0;0;0;0.0;52774058
2022-09-16;52;57;141;52.0;52774110
2022-09-16;23;13;138;-29.0;52774133
2022-09-16;18;17;100;-5.0;52774151
2022-09-16;4;5;62;-14.0;52774155
2022-09-16;27;23;119;23.0;52774182
2022-09-16;72;55;216;45.0;52774254
2022-09-16;61;48;121;-11.0;52774315
2022-09-16;10;11;108;-51.0;52774325
2022-09-16;36;29;174;26.0;52774361
2022-09-16;11;7;99;-25.0;52774372
2022-09-16;4;7;0;-7.0;52774376
2022-09-16;19;24;161;15.0;52774395
2022-09-16;7;17;6;-12.0;52774402
2022-09-16;344;313;1445;337.0;52774746
2022-09-17;43;33;75;-301.0;52774789
2022-09-17;3;3;30;-40.0;52774792
2022-09-17;158;170;522;155.0;52774950
2022-09-17;10;9;45;-148.0;52774960
2022-09-17;15;9;1;5.0;52774975
2022-09-17;2;2;18;-13.0;52774977
2022-09-17;20;22;60;18.0;52774997
2022-09-17;2;2;19;-18.0;52774999
2022-09-17;17;24;6;15.0;52775016
2022-09-17;18;26;82;1.0;52775034
2022-09-17;0;1;0;-18.0;52775034
2022-09-17;5;4;33;5.0;52775039
2022-09-17;8;12;74;3.0;52775047
2022-09-17;1;3;15;-7.0;52775048
2022-09-17;14;20;64;13.0;52775062
2022-09-18;0;0;7;-14.0;52775062
2022-09-18;3;2;1;3.0;52775065
2022-09-18;2;3;9;-1.0;52775067
2022-09-18;5;4;4;3.0;52775072
2022-09-18;4;7;10;-1.0;52775076
2022-09-18;0;0;2;-4.0;52775076
2022-09-18;9;7;18;9.0;52775085
2022-09-18;5;6;2;-4.0;52775090
2022-09-18;5;4;15;0.0;52775095
2022-09-18;56;63;132;51.0;52775151
2022-09-18;0;0;0;-56.0;52775151
2022-09-18;0;0;8;0.0;52775151
2022-09-18;5;6;16;5.0;52775156
2022-09-18;11;13;21;6.0;52775167
2022-09-18;7;11;19;-4.0;52775174
2022-09-19;8;11;3;1.0;52775182
2022-09-19;186;193;829;178.0;52775368
2022-09-19;19;19;72;-167.0;52775387
2022-09-19;6;5;1;-13.0;52775393
2022-09-19;3;8;78;-3.0;52775396
2022-09-19;5;6;54;2.0;52775401
2022-09-19;19;13;101;14.0;52775420
2022-09-19;4;10;42;-15.0;52775424
2022-09-19;12;9;63;8.0;52775436
2022-09-19;1;0;0;-11.0;52775437
2022-09-19;26;29;55;25.0;52775463
2022-09-19;20;24;92;-6.0;52775483
2022-09-19;33;28;149;13.0;52775516
2022-09-19;28;30;91;-5.0;52775544
2022-09-19;2;1;28;-26.0;52775546
2022-09-20;36;48;196;34.0;52775582
2022-09-20;241;280;1381;205.0;52775823
2022-09-20;26;31;104;-215.0;52775849
2022-09-20;29;28;173;3.0;52775878
2022-09-20;4;6;1;-25.0;52775882
2022-09-20;1;0;1;-3.0;52775883
2022-09-20;12;10;123;11.0;52775895
2022-09-20;9;10;116;-3.0;52775904
2022-09-20;8;10;142;-1.0;52775912
2022-09-20;6;6;68;-2.0;52775918
2022-09-20;9;8;9;3.0;52775927
2022-09-20;16;18;150;7.0;52775943
2022-09-20;32;43;90;16.0;52775975
2022-09-20;18;14;87;-14.0;52775993
2022-09-20;35;48;121;17.0;52776028
2022-09-21;10;8;66;-25.0;52776038
2022-09-21;28;29;103;18.0;52776066
2022-09-21;25;28;84;-3.0;52776091
2022-09-21;6;5;66;-19.0;52776097
2022-09-21;27;23;8;21.0;52776124
2022-09-21;19;14;6;-8.0;52776143
2022-09-21;267;247;971;248.0;52776410
2022-09-21;0;0;0;-267.0;52776410
2022-09-21;7;5;56;7.0;52776417
2022-09-21;59;59;95;52.0;52776476
2022-09-21;10;9;57;-49.0;52776486
2022-09-21;35;33;137;25.0;52776521
2022-09-21;16;17;126;-19.0;52776537
2022-09-21;22;16;126;6.0;52776559
2022-09-21;3;1;41;-19.0;52776562
2022-09-22;31;43;156;28.0;52776593
2022-09-22;234;234;1183;203.0;52776827
2022-09-22;2;5;67;-232.0;52776829
2022-09-22;11;13;93;9.0;52776840
2022-09-22;30;26;76;19.0;52776870
2022-09-22;36;28;91;6.0;52776906
2022-09-22;4;0;3;-32.0;52776910
2022-09-22;39;34;149;35.0;52776949
2022-09-22;26;23;154;-13.0;52776975
2022-09-22;10;6;96;-16.0;52776985
2022-09-22;11;9;90;1.0;52776996
2022-09-22;19;26;95;8.0;52777015
2022-09-22;1;1;1;-18.0;52777016
2022-09-22;1;1;0;0.0;52777017
2022-09-22;13;19;112;12.0;52777030
2022-09-23;55;51;219;42.0;52777085
2022-09-23;3;4;4;-52.0;52777088
2022-09-23;11;10;108;8.0;52777099
2022-09-23;12;7;65;1.0;52777111
2022-09-23;16;9;104;4.0;52777127
2022-09-23;9;9;131;-7.0;52777136
2022-09-23;5;6;107;-4.0;52777141
2022-09-23;56;41;151;51.0;52777197
2022-09-23;7;13;10;-49.0;52777204
2022-09-23;42;40;196;35.0;52777246
2022-09-23;52;44;134;10.0;52777298
2022-09-23;25;24;122;-27.0;52777323
2022-09-23;0;0;0;-25.0;52777323
2022-09-23;29;35;230;29.0;52777352
2022-09-23;322;293;1581;293.0;52777674
2022-09-24;24;20;65;-298.0;52777698
2022-09-24;6;5;37;-18.0;52777704
2022-09-24;175;181;603;169.0;52777879
2022-09-24;7;3;33;-168.0;52777886
2022-09-24;9;21;11;2.0;52777895
2022-09-24;0;0;0;-9.0;52777895
2022-09-24;8;5;35;8.0;52777903
2022-09-24;6;2;26;-2.0;52777909
2022-09-24;0;1;19;-6.0;52777909
2022-09-24;10;16;0;10.0;52777919
2022-09-24;19;19;82;9.0;52777938
2022-09-24;10;15;49;-9.0;52777948
2022-09-24;14;22;66;4.0;52777962
2022-09-24;19;14;63;5.0;52777981
2022-09-24;43;38;117;24.0;52778024
2022-09-25;45;70;129;2.0;52778069
2022-09-25;0;1;7;-45.0;52778069
2022-09-25;9;15;18;9.0;52778078
2022-09-25;0;0;0;-9.0;52778078
2022-09-25;11;8;13;11.0;52778089
2022-09-25;0;0;3;-11.0;52778089
2022-09-25;3;4;0;3.0;52778092
2022-09-25;4;6;10;1.0;52778096
2022-09-25;0;0;7;-4.0;52778096
2022-09-25;5;13;18;5.0;52778101
2022-09-25;4;5;16;-1.0;52778105
2022-09-25;5;13;28;1.0;52778110
2022-09-25;1;1;1;-4.0;52778111
2022-09-25;1;0;6;0.0;52778112
2022-09-25;2;4;2;1.0;52778114
2022-09-26;7;3;49;5.0;52778121
2022-09-26;3;11;70;-4.0;52778124
2022-09-26;0;1;0;-3.0;52778124
2022-09-26;5;9;57;5.0;52778129
2022-09-26;29;34;111;24.0;52778158
2022-09-26;180;225;835;151.0;52778338
2022-09-26;8;6;7;-172.0;52778346
2022-09-26;7;5;46;-1.0;52778353
2022-09-26;8;14;113;1.0;52778361
2022-09-26;4;4;37;-4.0;52778365
2022-09-26;6;2;0;2.0;52778371
2022-09-26;9;20;72;3.0;52778380
2022-09-26;16;22;63;7.0;52778396
2022-09-26;34;41;134;18.0;52778430
2022-09-26;44;53;76;10.0;52778474
2022-09-27;37;42;162;-7.0;52778511
2022-09-27;35;33;152;-2.0;52778546
2022-09-27;10;8;110;-25.0;52778556
2022-09-27;14;9;98;4.0;52778570
2022-09-27;1;0;0;-13.0;52778571
2022-09-27;33;26;74;32.0;52778604
2022-09-27;31;30;156;-2.0;52778635
2022-09-27;254;255;1222;223.0;52778889
2022-09-27;17;22;78;-237.0;52778906
2022-09-27;8;8;106;-9.0;52778914
2022-09-27;4;5;7;-4.0;52778918
2022-09-27;4;10;2;0.0;52778922
2022-09-27;3;5;64;-1.0;52778925
2022-09-27;19;16;82;16.0;52778944
2022-09-27;38;41;131;19.0;52778982
2022-09-28;31;28;100;-7.0;52779013
2022-09-28;28;25;129;-3.0;52779041
2022-09-28;26;22;114;-2.0;52779067
2022-09-28;22;27;16;-4.0;52779089
2022-09-28;9;8;37;-13.0;52779098
2022-09-28;13;24;0;4.0;52779111
2022-09-28;43;57;117;30.0;52779154
2022-09-28;14;11;65;-29.0;52779168
2022-09-28;20;26;125;6.0;52779188
2022-09-28;246;264;967;226.0;52779434
2022-09-28;12;8;77;-234.0;52779446
2022-09-28;7;10;65;-5.0;52779453
2022-09-28;5;2;56;-2.0;52779458
2022-09-28;16;16;66;11.0;52779474
2022-09-28;0;0;0;-16.0;52779474
2022-09-29;22;11;68;22.0;52779496
2022-09-29;37;28;111;15.0;52779533
2022-09-29;6;7;1;-31.0;52779539
2022-09-29;10;13;80;4.0;52779549
2022-09-29;21;25;81;11.0;52779570
2022-09-29;0;0;0;-21.0;52779570
2022-09-29;243;220;1143;243.0;52779813
2022-09-29;10;7;76;-233.0;52779823
2022-09-29;29;24;137;19.0;52779852
2022-09-29;5;6;5;-24.0;52779857
2022-09-29;13;15;92;8.0;52779870
2022-09-29;27;23;144;14.0;52779897
2022-09-29;12;10;113;-15.0;52779909
2022-09-29;9;10;96;-3.0;52779918
2022-09-29;42;41;139;33.0;52779960
2022-09-30;9;24;12;-33.0;52779969
2022-09-30;9;7;88;0.0;52779978
2022-09-30;36;26;191;27.0;52780014
2022-09-30;15;6;95;-21.0;52780029
2022-09-30;16;14;110;1.0;52780045
2022-09-30;3;13;2;-13.0;52780048
2022-09-30;49;65;115;46.0;52780097
2022-09-30;49;39;187;0.0;52780146
2022-09-30;31;36;105;-18.0;52780177
2022-09-30;36;44;169;5.0;52780213
2022-09-30;0;0;0;-36.0;52780213
2022-09-30;8;6;94;8.0;52780221
2022-09-30;37;51;125;29.0;52780258
2022-09-30;305;333;1353;268.0;52780563
2022-09-30;7;2;60;-298.0;52780570
2022-10-01;4;4;19;-3.0;52780574
2022-10-01;22;34;102;18.0;52780596
2022-10-01;10;10;33;-12.0;52780606
2022-10-01;2;1;19;-8.0;52780608
2022-10-01;23;26;110;21.0;52780631
2022-10-01;21;46;152;-2.0;52780652
2022-10-01;5;5;22;-16.0;52780657
2022-10-01;192;238;764;187.0;52780849
2022-10-01;20;22;71;-172.0;52780869
2022-10-01;22;20;86;2.0;52780891
2022-10-01;0;0;0;-22.0;52780891
2022-10-01;11;14;11;11.0;52780902
2022-10-01;14;18;3;3.0;52780916
2022-10-01;36;37;122;22.0;52780952
2022-10-01;2;1;14;-34.0;52780954
2022-10-02;0;0;4;-2.0;52780954
2022-10-02;0;2;0;0.0;52780954
2022-10-02;0;2;5;0.0;52780954
2022-10-02;0;2;0;0.0;52780954
2022-10-02;6;5;12;6.0;52780960
2022-10-02;3;1;1;-3.0;52780963
2022-10-02;5;9;4;2.0;52780968
2022-10-02;1;0;7;-4.0;52780969
2022-10-02;2;5;17;1.0;52780971
2022-10-02;0;1;1;-2.0;52780971
2022-10-02;2;2;1;2.0;52780973
2022-10-02;3;0;15;1.0;52780976
2022-10-02;4;3;13;1.0;52780980
2022-10-02;28;42;91;24.0;52781008
2022-10-02;2;10;11;-26.0;52781010
2022-10-03;4;4;30;2.0;52781014
2022-10-03;12;11;49;8.0;52781026
2022-10-03;33;30;76;21.0;52781059
2022-10-03;1;3;1;-32.0;52781060
2022-10-03;81;57;106;80.0;52781141
2022-10-03;10;4;64;-71.0;52781151
2022-10-03;1;4;1;-9.0;52781152
2022-10-03;2;5;53;1.0;52781154
2022-10-03;15;30;117;13.0;52781169
2022-10-03;9;14;60;-6.0;52781178
2022-10-03;29;44;116;20.0;52781207
2022-10-03;67;97;182;38.0;52781274
2022-10-03;319;361;959;252.0;52781593
2022-10-03;52;55;99;-267.0;52781645
2022-10-03;3;3;5;-49.0;52781648
2022-10-04;7;11;66;4.0;52781655
2022-10-04;5;7;87;-2.0;52781660
2022-10-04;15;12;91;10.0;52781675
2022-10-04;3;7;15;-12.0;52781678
2022-10-04;9;3;54;6.0;52781687
2022-10-04;35;29;99;26.0;52781722
2022-10-04;80;33;130;45.0;52781802
2022-10-04;28;25;142;-52.0;52781830
2022-10-04;345;246;1212;317.0;52782175
2022-10-04;20;11;107;-325.0;52782195
2022-10-04;1;0;0;-19.0;52782196
2022-10-04;30;24;147;29.0;52782226
2022-10-04;75;50;172;45.0;52782301
2022-10-04;34;32;102;-41.0;52782335
2022-10-04;3;2;0;-31.0;52782338
2022-10-05;263;266;889;260.0;52782601
2022-10-05;7;3;39;-256.0;52782608
2022-10-05;8;8;58;1.0;52782616
2022-10-05;15;10;53;7.0;52782631
2022-10-05;22;17;97;7.0;52782653
2022-10-05;23;23;134;1.0;52782676
2022-10-05;45;56;107;22.0;52782721
2022-10-05;30;33;122;-15.0;52782751
2022-10-05;42;34;85;12.0;52782793
2022-10-05;0;0;0;-42.0;52782793
2022-10-05;5;4;56;5.0;52782798
2022-10-05;7;9;52;2.0;52782805
2022-10-05;13;22;3;6.0;52782818
2022-10-05;13;21;10;0.0;52782831
2022-10-05;33;26;73;20.0;52782864
2022-10-06;45;36;123;12.0;52782909
2022-10-06;22;29;141;-23.0;52782931
2022-10-06;12;9;60;-10.0;52782943
2022-10-06;12;5;80;0.0;52782955
2022-10-06;26;27;61;14.0;52782981
2022-10-06;8;11;76;-18.0;52782989
2022-10-06;12;11;106;4.0;52783001
2022-10-06;15;21;138;3.0;52783016
2022-10-06;32;33;72;17.0;52783048
2022-10-06;34;27;103;2.0;52783082
2022-10-06;238;231;1056;204.0;52783320
2022-10-06;14;11;91;-224.0;52783334
2022-10-06;5;8;5;-9.0;52783339
2022-10-06;1;3;0;-4.0;52783340
2022-10-06;0;0;0;-1.0;52783340
2022-10-07;18;12;135;18.0;52783358
2022-10-07;8;12;8;-10.0;52783366
2022-10-07;48;55;124;40.0;52783414
2022-10-07;317;307;1469;269.0;52783731
2022-10-07;11;10;132;-306.0;52783742
2022-10-07;31;26;85;20.0;52783773
2022-10-07;41;52;180;10.0;52783814
2022-10-07;15;8;91;-26.0;52783829
2022-10-07;27;26;191;12.0;52783856
2022-10-07;29;37;178;2.0;52783885
2022-10-07;2;8;1;-27.0;52783887
2022-10-07;63;42;142;61.0;52783950
2022-10-07;8;7;119;-55.0;52783958
2022-10-07;15;11;83;7.0;52783973
2022-10-07;1;1;0;-14.0;52783974
2022-10-08;11;7;40;10.0;52783985
2022-10-08;11;16;14;0.0;52783996
2022-10-08;151;171;623;140.0;52784147
2022-10-08;8;13;1;-143.0;52784155
2022-10-08;13;16;69;5.0;52784168
2022-10-08;17;31;83;4.0;52784185
2022-10-08;36;33;118;19.0;52784221
2022-10-08;3;3;19;-33.0;52784224
2022-10-08;6;7;44;3.0;52784230
2022-10-08;3;0;24;-3.0;52784233
2022-10-08;17;17;51;14.0;52784250
2022-10-08;8;7;39;-9.0;52784258
2022-10-08;0;0;0;-8.0;52784258
2022-10-08;17;19;95;17.0;52784275
2022-10-08;1;2;26;-16.0;52784276
2022-10-09;1;3;7;0.0;52784277
2022-10-09;8;11;25;7.0;52784285
2022-10-09;0;0;0;-8.0;52784285
2022-10-09;0;0;4;0.0;52784285
2022-10-09;5;8;20;5.0;52784290
2022-10-09;1;3;3;-4.0;52784291
2022-10-09;6;7;13;5.0;52784297
2022-10-09;0;1;4;-6.0;52784297
2022-10-09;42;56;132;42.0;52784339
2022-10-09;1;1;4;-41.0;52784340
2022-10-09;3;5;0;2.0;52784343
2022-10-09;7;8;15;4.0;52784350
2022-10-09;8;5;13;1.0;52784358
2022-10-09;0;0;6;-8.0;52784358
2022-10-09;2;4;18;2.0;52784360
2022-10-10;4;1;0;2.0;52784364
2022-10-10;10;5;62;6.0;52784374
2022-10-10;224;278;1040;214.0;52784598
2022-10-10;28;37;126;-196.0;52784626
2022-10-10;5;4;3;-23.0;52784631
2022-10-10;50;68;152;45.0;52784681
2022-10-10;14;21;75;-36.0;52784695
2022-10-10;35;39;110;21.0;52784730
2022-10-10;18;24;141;-17.0;52784748
2022-10-10;8;9;49;-10.0;52784756
2022-10-10;13;13;82;5.0;52784769
2022-10-10;22;37;98;9.0;52784791
2022-10-10;9;12;67;-13.0;52784800
2022-10-10;0;0;1;-9.0;52784800
2022-10-10;8;8;74;8.0;52784808
2022-10-11;33;31;93;25.0;52784841
2022-10-11;29;22;74;-4.0;52784870
2022-10-11;2;0;0;-27.0;52784872
2022-10-11;1;7;4;-1.0;52784873
2022-10-11;17;8;172;16.0;52784890
2022-10-11;271;224;1535;254.0;52785161
2022-10-11;13;9;111;-258.0;52785174
2022-10-11;3;5;0;-10.0;52785177
2022-10-11;27;19;176;24.0;52785204
2022-10-11;45;38;179;18.0;52785249
2022-10-11;11;10;147;-34.0;52785260
2022-10-11;31;38;78;20.0;52785291
2022-10-11;29;17;226;-2.0;52785320
2022-10-11;12;9;103;-17.0;52785332
2022-10-11;18;11;172;6.0;52785350
2022-10-12;17;16;161;-1.0;52785367
2022-10-12;15;13;110;-2.0;52785382
2022-10-12;44;36;133;29.0;52785426
2022-10-12;18;8;107;-26.0;52785444
2022-10-12;14;15;91;-4.0;52785458
2022-10-12;0;0;0;-14.0;52785458
2022-10-12;18;9;98;18.0;52785476
2022-10-12;20;16;72;2.0;52785496
2022-10-12;25;22;112;5.0;52785521
2022-10-12;31;32;95;6.0;52785552
2022-10-12;7;12;3;-24.0;52785559
2022-10-12;11;7;74;4.0;52785570
2022-10-12;263;268;1193;252.0;52785833
2022-10-12;14;34;10;-249.0;52785847
2022-10-12;29;48;127;15.0;52785876
2022-10-13;269;264;1308;240.0;52786145
2022-10-13;44;57;121;-225.0;52786189
2022-10-13;35;35;152;-9.0;52786224
2022-10-13;0;0;0;-35.0;52786224
2022-10-13;10;11;106;10.0;52786234
2022-10-13;24;20;183;14.0;52786258
2022-10-13;5;3;8;-19.0;52786263
2022-10-13;30;25;85;25.0;52786293
2022-10-13;29;41;93;-1.0;52786322
2022-10-13;12;7;99;-17.0;52786334
2022-10-13;21;11;142;9.0;52786355
2022-10-13;16;12;137;-5.0;52786371
2022-10-13;17;13;121;1.0;52786388
2022-10-13;5;7;1;-12.0;52786393
2022-10-13;21;22;60;16.0;52786414
2022-10-14;31;21;262;10.0;52786445
2022-10-14;25;13;155;-6.0;52786470
2022-10-14;41;78;133;16.0;52786511
2022-10-14;31;40;172;-10.0;52786542
2022-10-14;12;12;191;-19.0;52786554
2022-10-14;4;8;1;-8.0;52786558
2022-10-14;1;0;0;-3.0;52786559
2022-10-14;18;10;122;17.0;52786577
2022-10-14;13;13;12;-5.0;52786590
2022-10-14;53;51;195;40.0;52786643
2022-10-14;13;4;109;-40.0;52786656
2022-10-14;347;337;1708;334.0;52787003
2022-10-14;27;15;158;-320.0;52787030
2022-10-14;41;44;122;14.0;52787071
2022-10-14;37;28;76;-4.0;52787108
2022-10-15;4;6;2;-33.0;52787112
2022-10-15;24;21;77;20.0;52787136
2022-10-15;25;30;95;1.0;52787161
2022-10-15;0;0;0;-25.0;52787161
2022-10-15;5;3;45;5.0;52787166
2022-10-15;24;30;102;19.0;52787190
2022-10-15;1;1;32;-23.0;52787191
2022-10-15;9;26;58;8.0;52787200
2022-10-15;9;8;9;0.0;52787209
2022-10-15;147;182;730;138.0;52787356
2022-10-15;12;31;64;-135.0;52787368
2022-10-15;6;6;57;-6.0;52787374
2022-10-15;8;6;53;2.0;52787382
2022-10-15;3;1;36;-5.0;52787385
2022-10-15;17;13;100;14.0;52787402
2022-10-16;2;3;11;-15.0;52787404
2022-10-16;4;6;14;2.0;52787408
2022-10-16;8;5;20;4.0;52787416
2022-10-16;2;3;21;-6.0;52787418
2022-10-16;1;1;11;-1.0;52787419
2022-10-16;1;0;1;0.0;52787420
2022-10-16;3;1;1;2.0;52787423
2022-10-16;5;6;14;2.0;52787428
2022-10-16;0;2;6;-5.0;52787428
2022-10-16;8;8;26;8.0;52787436
2022-10-16;2;0;12;-6.0;52787438
2022-10-16;43;42;155;41.0;52787481
2022-10-16;2;0;7;-41.0;52787483
2022-10-16;5;7;11;3.0;52787488
2022-10-16;0;0;0;-5.0;52787488
2022-10-17;15;13;101;15.0;52787503
2022-10-17;17;20;80;2.0;52787520
2022-10-17;20;27;121;3.0;52787540
2022-10-17;5;4;2;-15.0;52787545
2022-10-17;14;8;103;9.0;52787559
2022-10-17;1;1;0;-13.0;52787560
2022-10-17;7;9;63;6.0;52787567
2022-10-17;7;9;74;0.0;52787574
2022-10-17;2;3;1;-5.0;52787576
2022-10-17;15;20;77;13.0;52787591
2022-10-17;183;203;1100;168.0;52787774
2022-10-17;16;18;157;-167.0;52787790
2022-10-17;30;31;103;14.0;52787820
2022-10-17;26;29;132;-4.0;52787846
2022-10-17;8;11;86;-18.0;52787854
2022-10-18;0;1;1;-8.0;52787854
2022-10-18;28;21;203;28.0;52787882
2022-10-18;18;26;82;-10.0;52787900
2022-10-18;21;18;165;3.0;52787921
2022-10-18;30;31;169;9.0;52787951
2022-10-18;32;35;107;2.0;52787983
2022-10-18;250;238;1705;218.0;52788233
2022-10-18;22;15;165;-228.0;52788255
2022-10-18;25;27;186;3.0;52788280
2022-10-18;19;12;112;-6.0;52788299
2022-10-18;15;14;168;-4.0;52788314
2022-10-18;3;4;6;-12.0;52788317
2022-10-18;3;5;0;0.0;52788320
2022-10-18;25;24;229;22.0;52788345
2022-10-18;9;5;112;-16.0;52788354
2022-10-19;11;13;83;2.0;52788365
2022-10-19;15;28;118;4.0;52788380
2022-10-19;14;8;160;-1.0;52788394
2022-10-19;13;8;139;-1.0;52788407
2022-10-19;30;26;70;17.0;52788437
2022-10-19;22;15;133;-8.0;52788459
2022-10-19;25;22;180;3.0;52788484
2022-10-19;254;280;1340;229.0;52788738
2022-10-19;0;0;0;-254.0;52788738
2022-10-19;11;20;6;11.0;52788749
2022-10-19;26;41;90;15.0;52788775
2022-10-19;28;38;83;2.0;52788803
2022-10-19;10;15;150;-18.0;52788813
2022-10-19;35;35;125;25.0;52788848
2022-10-19;14;11;3;-21.0;52788862
2022-10-20;28;40;110;14.0;52788890
2022-10-20;22;15;92;-6.0;52788912
2022-10-20;27;23;66;5.0;52788939
2022-10-20;21;28;140;-6.0;52788960
2022-10-20;15;10;167;-6.0;52788975
2022-10-20;38;41;153;23.0;52789013
2022-10-20;271;256;1649;233.0;52789284
2022-10-20;7;6;3;-264.0;52789291
2022-10-20;21;12;127;14.0;52789312
2022-10-20;18;21;212;-3.0;52789330
2022-10-20;0;0;0;-18.0;52789330
2022-10-20;22;15;203;22.0;52789352
2022-10-20;22;14;184;0.0;52789374
2022-10-20;6;7;9;-16.0;52789380
2022-10-20;24;24;183;18.0;52789404
2022-10-21;19;7;218;-5.0;52789423
2022-10-21;10;11;8;-9.0;52789433
2022-10-21;18;30;95;8.0;52789451
2022-10-21;10;8;141;-8.0;52789461
2022-10-21;4;3;3;-6.0;52789465
2022-10-21;29;47;174;25.0;52789494
2022-10-21;263;281;2011;234.0;52789757
2022-10-21;26;50;103;-237.0;52789783
2022-10-21;1;0;0;-25.0;52789784
2022-10-21;32;27;303;31.0;52789816
2022-10-21;28;34;131;-4.0;52789844
2022-10-21;28;11;213;0.0;52789872
2022-10-21;27;34;213;-1.0;52789899
2022-10-21;14;10;198;-13.0;52789913
2022-10-21;17;9;211;3.0;52789930
2022-10-22;141;142;574;124.0;52790071
2022-10-22;7;8;12;-134.0;52790078
2022-10-22;13;22;60;6.0;52790091
2022-10-22;6;2;45;-7.0;52790097
2022-10-22;27;21;69;21.0;52790124
2022-10-22;8;4;3;-19.0;52790132
2022-10-22;5;2;39;-3.0;52790137
2022-10-22;0;0;0;-5.0;52790137
2022-10-22;7;7;46;7.0;52790144
2022-10-22;10;10;82;3.0;52790154
2022-10-22;13;19;21;3.0;52790167
2022-10-22;7;6;42;-6.0;52790174
2022-10-22;19;17;61;12.0;52790193
2022-10-22;3;5;46;-16.0;52790196
2022-10-22;16;19;48;13.0;52790212
2022-10-23;13;15;13;-3.0;52790225
2022-10-23;0;2;9;-13.0;52790225
2022-10-23;2;1;5;2.0;52790227
2022-10-23;1;1;5;-1.0;52790228
2022-10-23;5;4;10;4.0;52790233
2022-10-23;5;3;16;0.0;52790238
2022-10-23;5;0;0;0.0;52790243
2022-10-23;7;8;15;2.0;52790250
2022-10-23;1;1;2;-6.0;52790251
2022-10-23;3;7;12;2.0;52790254
2022-10-23;1;1;5;-2.0;52790255
2022-10-23;51;53;106;50.0;52790306
2022-10-23;0;0;0;-51.0;52790306
2022-10-23;6;8;5;6.0;52790312
2022-10-23;2;2;9;-4.0;52790314
2022-10-24;15;8;93;13.0;52790329
2022-10-24;236;179;1168;221.0;52790565
2022-10-24;15;6;97;-221.0;52790580
2022-10-24;49;28;98;34.0;52790629
2022-10-24;5;5;13;-44.0;52790634
2022-10-24;30;25;101;25.0;52790664
2022-10-24;17;9;115;-13.0;52790681
2022-10-24;18;20;164;1.0;52790699
2022-10-24;29;26;123;11.0;52790728
2022-10-24;12;8;99;-17.0;52790740
2022-10-24;4;4;1;-8.0;52790744
2022-10-24;20;19;133;16.0;52790764
2022-10-24;19;20;62;-1.0;52790783
2022-10-24;0;0;0;-19.0;52790783
2022-10-24;3;1;69;3.0;52790786
2022-10-25;26;29;110;23.0;52790812
2022-10-25;36;49;125;10.0;52790848
2022-10-25;0;0;0;-36.0;52790848
2022-10-25;22;10;198;22.0;52790870
2022-10-25;15;9;114;-7.0;52790885
2022-10-25;20;32;239;5.0;52790905
2022-10-25;26;23;160;6.0;52790931
2022-10-25;266;244;1621;240.0;52791197
2022-10-25;17;14;169;-249.0;52791214
2022-10-25;6;6;15;-11.0;52791220
2022-10-25;3;3;1;-3.0;52791223
2022-10-25;27;13;189;24.0;52791250
2022-10-25;29;21;75;2.0;52791279
2022-10-25;23;16;158;-6.0;52791302
2022-10-25;16;19;68;-7.0;52791318
2022-10-26;31;37;99;15.0;52791349
2022-10-26;20;15;112;-11.0;52791369
2022-10-26;14;9;143;-6.0;52791383
2022-10-26;17;12;54;3.0;52791400
2022-10-26;17;11;196;0.0;52791417
2022-10-26;5;9;125;-12.0;52791422
2022-10-26;6;7;8;1.0;52791428
2022-10-26;8;5;7;2.0;52791436
2022-10-26;15;10;108;7.0;52791451
2022-10-26;26;25;72;11.0;52791477
2022-10-26;30;27;78;4.0;52791507
2022-10-26;0;0;0;-30.0;52791507
2022-10-26;12;4;92;12.0;52791519
2022-10-26;19;12;131;7.0;52791538
2022-10-26;220;183;1225;201.0;52791758
2022-10-27;27;19;161;-193.0;52791785
2022-10-27;1;0;0;-26.0;52791786
2022-10-27;21;15;199;20.0;52791807
2022-10-27;21;15;102;0.0;52791828
2022-10-27;27;21;118;6.0;52791855
2022-10-27;16;19;53;-11.0;52791871
2022-10-27;22;10;148;6.0;52791893
2022-10-27;15;21;87;-7.0;52791908
2022-10-27;38;22;95;23.0;52791946
2022-10-27;11;6;140;-27.0;52791957
2022-10-27;4;2;1;-7.0;52791961
2022-10-27;5;6;15;1.0;52791966
2022-10-27;250;201;1432;245.0;52792216
2022-10-27;27;34;125;-223.0;52792243
2022-10-27;15;11;188;-12.0;52792258
2022-10-28;19;8;154;4.0;52792277
2022-10-28;24;12;168;5.0;52792301
2022-10-28;30;29;158;6.0;52792331
2022-10-28;41;29;118;11.0;52792372
2022-10-28;6;5;15;-35.0;52792378
2022-10-28;29;31;130;23.0;52792407
2022-10-28;0;0;0;-29.0;52792407
2022-10-28;16;6;103;16.0;52792423
2022-10-28;31;39;77;15.0;52792454
2022-10-28;17;24;231;-14.0;52792471
2022-10-28;18;12;159;1.0;52792489
2022-10-28;286;231;1533;268.0;52792775
2022-10-28;20;12;148;-266.0;52792795
2022-10-28;28;20;71;8.0;52792823
2022-10-28;7;4;1;-21.0;52792830
2022-10-29;15;15;41;8.0;52792845
2022-10-29;9;3;35;-6.0;52792854
2022-10-29;6;2;41;-3.0;52792860
2022-10-29;11;15;53;5.0;52792871
2022-10-29;11;14;68;0.0;52792882
2022-10-29;12;16;64;1.0;52792894
2022-10-29;16;10;80;4.0;52792910
2022-10-29;7;3;1;-9.0;52792917
2022-10-29;7;4;26;0.0;52792924
2022-10-29;5;2;33;-2.0;52792929
2022-10-29;0;1;22;-5.0;52792929
2022-10-29;10;8;4;10.0;52792939
2022-10-29;123;101;493;113.0;52793062
2022-10-29;2;0;0;-121.0;52793064
2022-10-29;12;8;25;10.0;52793076
2022-10-30;0;0;0;-12.0;52793076
2022-10-30;0;0;12;0.0;52793076
2022-10-30;0;1;6;0.0;52793076
2022-10-30;0;1;2;0.0;52793076
2022-10-30;0;2;12;0.0;52793076
2022-10-30;6;0;15;6.0;52793082
2022-10-30;35;35;126;29.0;52793117
2022-10-30;0;0;6;-35.0;52793117
2022-10-30;4;8;11;4.0;52793121
2022-10-30;2;3;15;-2.0;52793123
2022-10-30;2;2;7;0.0;52793125
2022-10-30;7;5;8;5.0;52793132
2022-10-30;1;1;0;-6.0;52793133
2022-10-30;2;1;9;1.0;52793135
2022-10-30;11;11;23;9.0;52793146
2022-10-31;151;146;757;140.0;52793297
2022-10-31;5;3;8;-146.0;52793302
2022-10-31;18;22;70;13.0;52793320
2022-10-31;16;30;66;-2.0;52793336
2022-10-31;10;7;72;-6.0;52793346
2022-10-31;10;5;53;0.0;52793356
2022-10-31;21;12;72;11.0;52793377
2022-10-31;12;14;107;-9.0;52793389
2022-10-31;1;1;0;-11.0;52793390
2022-10-31;24;21;99;23.0;52793414
2022-10-31;10;13;49;-14.0;52793424
2022-10-31;4;2;67;-6.0;52793428
2022-10-31;3;2;1;-1.0;52793431
2022-10-31;7;5;38;4.0;52793438
2022-10-31;10;9;55;3.0;52793448
2022-11-01;1;2;1;-9.0;52793449
2022-11-01;12;15;67;11.0;52793461
2022-11-01;2;1;13;-10.0;52793463
2022-11-01;1;1;5;-1.0;52793464
2022-11-01;71;71;424;70.0;52793535
2022-11-01;20;13;72;-51.0;52793555
2022-11-01;1;1;12;-19.0;52793556
2022-11-01;2;4;21;1.0;52793558
2022-11-01;3;1;15;1.0;52793561
2022-11-01;2;0;0;-1.0;52793563
2022-11-01;16;15;101;14.0;52793579
2022-11-01;2;0;3;-14.0;52793581
2022-11-01;0;0;13;-2.0;52793581
2022-11-01;5;6;45;5.0;52793586
2022-11-01;4;12;56;-1.0;52793590
2022-11-02;70;34;108;66.0;52793660
2022-11-02;6;7;106;-64.0;52793666
2022-11-02;7;9;62;1.0;52793673
2022-11-02;6;7;91;-1.0;52793679
2022-11-02;14;7;100;8.0;52793693
2022-11-02;26;28;121;12.0;52793719
2022-11-02;5;8;3;-21.0;52793724
2022-11-02;20;24;62;15.0;52793744
2022-11-02;249;220;1157;229.0;52793993
2022-11-02;35;36;111;-214.0;52794028
2022-11-02;11;11;9;-24.0;52794039
2022-11-02;9;8;94;-2.0;52794048
2022-11-02;20;28;143;11.0;52794068
2022-11-02;19;12;146;-1.0;52794087
2022-11-02;1;1;1;-18.0;52794088
2022-11-03;6;1;0;5.0;52794094
2022-11-03;0;0;0;-6.0;52794094
2022-11-03;21;19;126;21.0;52794115
2022-11-03;17;22;73;-4.0;52794132
2022-11-03;4;5;6;-13.0;52794136
2022-11-03;9;5;89;5.0;52794145
2022-11-03;19;15;141;10.0;52794164
2022-11-03;22;15;126;3.0;52794186
2022-11-03;28;29;199;6.0;52794214
2022-11-03;35;45;111;7.0;52794249
2022-11-03;13;13;130;-22.0;52794262
2022-11-03;295;238;1375;282.0;52794557
2022-11-03;22;22;151;-273.0;52794579
2022-11-03;18;9;137;-4.0;52794597
2022-11-03;81;38;86;63.0;52794678
2022-11-04;17;6;145;-64.0;52794695
2022-11-04;300;248;1538;283.0;52794995
2022-11-04;12;8;92;-288.0;52795007
2022-11-04;23;21;70;11.0;52795030
2022-11-04;18;11;137;-5.0;52795048
2022-11-04;45;43;114;27.0;52795093
2022-11-04;41;38;147;-4.0;52795134
2022-11-04;8;3;0;-33.0;52795142
2022-11-04;1;0;0;-7.0;52795143
2022-11-04;35;27;241;34.0;52795178
2022-11-04;25;27;153;-10.0;52795203
2022-11-04;4;9;14;-21.0;52795207
2022-11-04;38;34;150;34.0;52795245
2022-11-04;14;12;131;-24.0;52795259
2022-11-04;19;9;144;5.0;52795278
2022-11-05;0;0;0;-19.0;52795278
2022-11-05;9;12;36;9.0;52795287
2022-11-05;22;17;36;13.0;52795309
2022-11-05;8;10;88;-14.0;52795317
2022-11-05;6;3;32;-2.0;52795323
2022-11-05;14;16;62;8.0;52795337
2022-11-05;16;25;63;2.0;52795353
2022-11-05;4;7;36;-12.0;52795357
2022-11-05;1;2;27;-3.0;52795358
2022-11-05;4;3;29;3.0;52795362
2022-11-05;11;15;41;7.0;52795373
2022-11-05;10;19;64;-1.0;52795383
2022-11-05;10;5;1;0.0;52795393
2022-11-05;2;7;7;-8.0;52795395
2022-11-05;117;141;522;115.0;52795512
2022-11-06;3;1;11;-114.0;52795515
2022-11-06;0;3;0;-3.0;52795515
2022-11-06;1;8;6;1.0;52795516
2022-11-06;5;3;11;4.0;52795521
2022-11-06;4;7;9;-1.0;52795525
2022-11-06;0;0;8;-4.0;52795525
2022-11-06;0;0;0;0.0;52795525
2022-11-06;1;2;5;1.0;52795526
2022-11-06;10;9;18;9.0;52795536
2022-11-06;1;1;4;-9.0;52795537
2022-11-06;2;1;8;1.0;52795539
2022-11-06;0;3;3;-2.0;52795539
2022-11-06;4;5;12;4.0;52795543
2022-11-06;36;50;104;32.0;52795579
2022-11-06;5;7;9;-31.0;52795584
2022-11-07;2;2;2;-3.0;52795586
2022-11-07;31;22;150;29.0;52795617
2022-11-07;47;52;69;16.0;52795664
2022-11-07;0;0;0;-47.0;52795664
2022-11-07;14;26;46;14.0;52795678
2022-11-07;11;7;83;-3.0;52795689
2022-11-07;22;26;117;11.0;52795711
2022-11-07;34;50;126;12.0;52795745
2022-11-07;3;1;4;-31.0;52795748
2022-11-07;30;33;59;27.0;52795778
2022-11-07;11;12;95;-19.0;52795789
2022-11-07;8;7;85;-3.0;52795797
2022-11-07;238;247;994;230.0;52796035
2022-11-07;12;4;68;-226.0;52796047
2022-11-07;13;5;90;1.0;52796060
2022-11-08;52;44;144;39.0;52796112
2022-11-08;21;23;209;-31.0;52796133
2022-11-08;2;5;9;-19.0;52796135
2022-11-08;313;268;1708;311.0;52796448
2022-11-08;38;22;83;-275.0;52796486
2022-11-08;1;0;0;-37.0;52796487
2022-11-08;37;42;126;36.0;52796524
2022-11-08;29;32;231;-8.0;52796553
2022-11-08;10;2;1;-19.0;52796563
2022-11-08;12;16;59;2.0;52796575
2022-11-08;14;12;174;2.0;52796589
2022-11-08;38;27;132;24.0;52796627
2022-11-08;16;12;144;-22.0;52796643
2022-11-08;16;11;214;0.0;52796659
2022-11-08;27;20;182;11.0;52796686
2022-11-09;0;0;1;-27.0;52796686
2022-11-09;19;20;143;19.0;52796705
2022-11-09;17;11;102;-2.0;52796722
2022-11-09;10;16;175;-7.0;52796732
2022-11-09;35;23;73;25.0;52796767
2022-11-09;33;37;108;-2.0;52796800
2022-11-09;35;32;97;2.0;52796835
2022-11-09;15;9;110;-20.0;52796850
2022-11-09;21;21;49;6.0;52796871
2022-11-09;5;3;76;-16.0;52796876
2022-11-09;229;210;1168;224.0;52797105
2022-11-09;4;7;7;-225.0;52797109
2022-11-09;15;8;123;11.0;52797124
2022-11-09;13;10;101;-2.0;52797137
2022-11-09;7;13;3;-6.0;52797144
2022-11-10;14;4;163;7.0;52797158
2022-11-10;4;6;1;-10.0;52797162
2022-11-10;21;13;170;17.0;52797183
2022-11-10;0;0;2;-21.0;52797183
2022-11-10;26;31;151;26.0;52797209
2022-11-10;252;296;1553;226.0;52797461
2022-11-10;15;12;145;-237.0;52797476
2022-11-10;12;6;170;-3.0;52797488
2022-11-10;23;17;193;11.0;52797511
2022-11-10;41;57;178;18.0;52797552
2022-11-10;11;13;101;-30.0;52797563
2022-11-10;26;26;77;15.0;52797589
2022-11-10;23;46;99;-3.0;52797612
2022-11-10;4;8;7;-19.0;52797616
2022-11-10;32;57;96;28.0;52797648
2022-11-11;3;1;6;-29.0;52797651
2022-11-11;0;1;9;-3.0;52797651
2022-11-11;5;0;16;5.0;52797656
2022-11-11;6;5;22;1.0;52797662
2022-11-11;3;2;12;-3.0;52797665
2022-11-11;0;3;0;-3.0;52797665
2022-11-11;2;2;9;2.0;52797667
2022-11-11;1;1;11;-1.0;52797668
2022-11-11;0;1;1;-1.0;52797668
2022-11-11;1;4;19;1.0;52797669
2022-11-11;36;38;137;35.0;52797705
2022-11-11;2;4;0;-34.0;52797707
2022-11-11;1;1;1;-1.0;52797708
2022-11-11;10;8;19;9.0;52797718
2022-11-11;2;5;12;-8.0;52797720
2022-11-12;11;18;38;9.0;52797731
2022-11-12;8;21;26;-3.0;52797739
2022-11-12;25;19;58;17.0;52797764
2022-11-12;1;3;22;-24.0;52797765
2022-11-12;8;10;53;7.0;52797773
2022-11-12;4;1;8;-4.0;52797777
2022-11-12;99;121;424;95.0;52797876
2022-11-12;3;5;32;-96.0;52797879
2022-11-12;0;0;0;-3.0;52797879
2022-11-12;9;3;23;9.0;52797888
2022-11-12;3;1;18;-6.0;52797891
2022-11-12;13;18;65;10.0;52797904
2022-11-12;7;9;3;-6.0;52797911
2022-11-12;4;11;52;-3.0;52797915
2022-11-12;3;2;26;-1.0;52797918
2022-11-13;4;5;19;1.0;52797922
2022-11-13;3;4;4;-1.0;52797925
2022-11-13;0;1;6;-3.0;52797925
2022-11-13;1;3;9;1.0;52797926
2022-11-13;2;0;10;1.0;52797928
2022-11-13;5;6;9;3.0;52797933
2022-11-13;5;2;10;0.0;52797938
2022-11-13;2;3;0;-3.0;52797940
2022-11-13;0;1;0;-2.0;52797940
2022-11-13;36;48;100;36.0;52797976
2022-11-13;0;1;5;-36.0;52797976
2022-11-13;0;0;0;0.0;52797976
2022-11-13;7;14;18;7.0;52797983
2022-11-13;1;0;4;-6.0;52797984
2022-11-13;6;8;6;5.0;52797990
2022-11-14;13;3;98;7.0;52798003
2022-11-14;14;11;55;1.0;52798017
2022-11-14;9;6;87;-5.0;52798026
2022-11-14;11;8;54;2.0;52798037
2022-11-14;13;11;52;2.0;52798050
2022-11-14;9;8;91;-4.0;52798059
2022-11-14;30;17;106;21.0;52798089
2022-11-14;0;0;0;-30.0;52798089
2022-11-14;14;10;90;14.0;52798103
2022-11-14;206;156;932;192.0;52798309
2022-11-14;23;17;119;-183.0;52798332
2022-11-14;4;5;1;-19.0;52798336
2022-11-14;31;24;78;27.0;52798367
2022-11-14;3;4;0;-28.0;52798370
2022-11-14;32;32;101;29.0;52798402
2022-11-15;33;33;115;1.0;52798435
2022-11-15;10;6;124;-23.0;52798445
2022-11-15;22;16;157;12.0;52798467
2022-11-15;1;5;2;-21.0;52798468
2022-11-15;273;312;1467;272.0;52798741
2022-11-15;32;50;99;-241.0;52798773
2022-11-15;14;22;232;-18.0;52798787
2022-11-15;21;19;160;7.0;52798808
2022-11-15;16;17;163;-5.0;52798824
2022-11-15;2;3;6;-14.0;52798826
2022-11-15;48;67;143;46.0;52798874
2022-11-15;0;0;0;-48.0;52798874
2022-11-15;31;41;64;31.0;52798905
2022-11-15;23;11;144;-8.0;52798928
2022-11-15;20;22;58;-3.0;52798948
2022-11-16;26;53;80;6.0;52798974
2022-11-16;22;18;121;-4.0;52798996
2022-11-16;261;249;1122;239.0;52799257
2022-11-16;17;9;103;-244.0;52799274
2022-11-16;2;6;3;-15.0;52799276
2022-11-16;12;6;74;10.0;52799288
2022-11-16;9;19;5;-3.0;52799297
2022-11-16;1;0;0;-8.0;52799298
2022-11-16;31;12;150;30.0;52799329
2022-11-16;11;7;109;-20.0;52799340
2022-11-16;13;9;129;2.0;52799353
2022-11-16;20;19;115;7.0;52799373
2022-11-16;43;34;99;23.0;52799416
2022-11-16;26;19;65;-17.0;52799442
2022-11-16;28;38;69;2.0;52799470
2022-11-17;25;30;78;-3.0;52799495
2022-11-17;15;16;64;-10.0;52799510
2022-11-17;11;15;133;-4.0;52799521
2022-11-17;19;13;144;8.0;52799540
2022-11-17;19;11;125;0.0;52799559
2022-11-17;3;8;1;-16.0;52799562
2022-11-17;0;6;4;-3.0;52799562
2022-11-17;17;9;93;17.0;52799579
2022-11-17;18;8;142;1.0;52799597
2022-11-17;19;22;110;1.0;52799616
2022-11-17;1;0;0;-18.0;52799617
2022-11-17;58;55;108;57.0;52799675
2022-11-17;23;20;202;-35.0;52799698
2022-11-17;14;21;50;-9.0;52799712
2022-11-17;242;234;1254;228.0;52799954
2022-11-18;27;32;110;-215.0;52799981
2022-11-18;23;11;143;-4.0;52800004
2022-11-18;3;7;5;-20.0;52800007
2022-11-18;21;20;228;18.0;52800028
2022-11-18;19;28;151;-2.0;52800047
2022-11-18;38;34;111;19.0;52800085
2022-11-18;23;21;79;-15.0;52800108
2022-11-18;16;11;143;-7.0;52800124
2022-11-18;12;5;83;-4.0;52800136
2022-11-18;15;14;146;3.0;52800151
2022-11-18;12;6;134;-3.0;52800163
2022-11-18;248;235;1476;236.0;52800411
2022-11-18;5;7;7;-243.0;52800416
2022-11-18;34;39;136;29.0;52800450
2022-11-18;0;0;0;-34.0;52800450
2022-11-19;2;1;17;2.0;52800452
2022-11-19;6;11;2;4.0;52800458
2022-11-19;21;22;56;15.0;52800479
2022-11-19;6;10;4;-15.0;52800485
2022-11-19;10;8;90;4.0;52800495
2022-11-19;3;8;24;-7.0;52800498
2022-11-19;124;119;464;121.0;52800622
2022-11-19;0;1;0;-124.0;52800622
2022-11-19;5;1;38;5.0;52800627
2022-11-19;1;2;29;-4.0;52800628
2022-11-19;20;15;46;19.0;52800648
2022-11-19;3;3;37;-17.0;52800651
2022-11-19;10;11;23;7.0;52800661
2022-11-19;18;13;47;8.0;52800679
2022-11-19;19;13;51;1.0;52800698
2022-11-20;1;1;0;-18.0;52800699
2022-11-20;2;9;20;1.0;52800701
2022-11-20;8;15;4;6.0;52800709
2022-11-20;4;0;8;-4.0;52800713
2022-11-20;5;14;17;1.0;52800718
2022-11-20;0;0;2;-5.0;52800718
2022-11-20;4;12;9;4.0;52800722
2022-11-20;1;0;8;-3.0;52800723
2022-11-20;5;1;13;4.0;52800728
2022-11-20;47;85;126;42.0;52800775
2022-11-20;3;3;0;-44.0;52800778
2022-11-20;0;0;4;-3.0;52800778
2022-11-20;7;22;28;7.0;52800785
2022-11-20;0;1;1;-7.0;52800785
2022-11-20;7;7;12;7.0;52800792
2022-11-21;13;18;98;6.0;52800805
2022-11-21;2;1;1;-11.0;52800807
2022-11-21;4;0;1;2.0;52800811
2022-11-21;196;139;847;192.0;52801007
2022-11-21;14;14;129;-182.0;52801021
2022-11-21;0;0;0;-14.0;52801021
2022-11-21;18;10;46;18.0;52801039
2022-11-21;6;3;84;-12.0;52801045
2022-11-21;29;30;88;23.0;52801074
2022-11-21;49;24;60;20.0;52801123
2022-11-21;17;10;70;-32.0;52801140
2022-11-21;12;9;94;-5.0;52801152
2022-11-21;17;8;54;5.0;52801169
2022-11-21;11;6;72;-6.0;52801180
2022-11-21;4;6;50;-7.0;52801184
2022-11-22;239;171;1347;235.0;52801423
2022-11-22;12;12;132;-227.0;52801435
2022-11-22;2;2;3;-10.0;52801437
2022-11-22;16;12;132;14.0;52801453
2022-11-22;1;1;0;-15.0;52801454
2022-11-22;34;23;163;33.0;52801488
2022-11-22;29;16;66;-5.0;52801517
2022-11-22;14;8;157;-15.0;52801531
2022-11-22;41;26;143;27.0;52801572
2022-11-22;24;18;193;-17.0;52801596
2022-11-22;25;21;88;1.0;52801621
2022-11-22;15;16;70;-10.0;52801636
2022-11-22;16;9;127;1.0;52801652
2022-11-22;0;0;1;-16.0;52801652
2022-11-22;10;7;72;10.0;52801662
2022-11-23;5;12;94;-5.0;52801667
2022-11-23;27;33;83;22.0;52801694
2022-11-23;16;9;7;-11.0;52801710
2022-11-23;5;2;88;-11.0;52801715
2022-11-23;14;3;105;9.0;52801729
2022-11-23;208;179;992;194.0;52801937
2022-11-23;17;10;108;-191.0;52801954
2022-11-23;19;16;37;2.0;52801973
2022-11-23;9;15;100;-10.0;52801982
2022-11-23;12;16;146;3.0;52801994
2022-11-23;2;0;0;-10.0;52801996
2022-11-23;35;24;89;33.0;52802031
2022-11-23;34;24;74;-1.0;52802065
2022-11-23;6;4;54;-28.0;52802071
2022-11-23;7;11;7;1.0;52802078
2022-11-24;13;9;142;6.0;52802091
2022-11-24;13;8;172;0.0;52802104
2022-11-24;16;14;51;3.0;52802120
2022-11-24;10;12;150;-6.0;52802130
2022-11-24;19;15;140;9.0;52802149
2022-11-24;1;0;0;-18.0;52802150
2022-11-24;35;24;97;34.0;52802185
2022-11-24;197;163;1271;162.0;52802382
2022-11-24;21;15;59;-176.0;52802403
2022-11-24;20;17;85;-1.0;52802423
2022-11-24;13;10;83;-7.0;52802436
2022-11-24;9;6;126;-4.0;52802445
2022-11-24;1;4;0;-8.0;52802446
2022-11-24;24;28;162;23.0;52802470
2022-11-24;2;1;4;-22.0;52802472
2022-11-25;3;8;6;1.0;52802475
2022-11-25;8;9;122;5.0;52802483
2022-11-25;24;27;67;16.0;52802507
2022-11-25;9;9;83;-15.0;52802516
2022-11-25;12;9;146;3.0;52802528
2022-11-25;31;30;181;19.0;52802559
2022-11-25;10;9;142;-21.0;52802569
2022-11-25;21;19;208;11.0;52802590
2022-11-25;0;0;1;-21.0;52802590
2022-11-25;46;36;147;46.0;52802636
2022-11-25;18;24;106;-28.0;52802654
2022-11-25;231;230;1439;213.0;52802885
2022-11-25;25;31;100;-206.0;52802910
2022-11-25;7;7;2;-18.0;52802917
2022-11-25;17;12;128;10.0;52802934
2022-11-26;0;0;0;-17.0;52802934
2022-11-26;12;18;33;12.0;52802946
2022-11-26;15;25;45;3.0;52802961
2022-11-26;18;22;63;3.0;52802979
2022-11-26;16;11;53;-2.0;52802995
2022-11-26;4;4;23;-12.0;52802999
2022-11-26;4;3;34;0.0;52803003
2022-11-26;14;6;28;10.0;52803017
2022-11-26;132;133;487;118.0;52803149
2022-11-26;9;9;7;-123.0;52803158
2022-11-26;4;0;29;-5.0;52803162
2022-11-26;10;5;82;6.0;52803172
2022-11-26;5;6;21;-5.0;52803177
2022-11-26;4;8;3;-1.0;52803181
2022-11-26;17;16;66;13.0;52803198
2022-11-27;37;34;105;20.0;52803235
2022-11-27;1;1;1;-36.0;52803236
2022-11-27;2;1;7;1.0;52803238
2022-11-27;0;3;10;-2.0;52803238
2022-11-27;0;3;15;0.0;52803238
2022-11-27;0;0;0;0.0;52803238
2022-11-27;2;4;5;2.0;52803240
2022-11-27;2;1;0;0.0;52803242
2022-11-27;3;2;5;1.0;52803245
2022-11-27;7;3;11;4.0;52803252
2022-11-27;3;4;18;-4.0;52803255
2022-11-27;3;1;5;0.0;52803258
2022-11-27;2;1;2;-1.0;52803260
2022-11-27;6;7;18;4.0;52803266
2022-11-27;6;3;8;0.0;52803272
2022-11-28;13;14;142;7.0;52803285
2022-11-28;15;13;83;2.0;52803300
2022-11-28;2;6;7;-13.0;52803302
2022-11-28;4;2;50;2.0;52803306
2022-11-28;9;19;49;5.0;52803315
2022-11-28;214;156;857;205.0;52803529
2022-11-28;10;8;69;-204.0;52803539
2022-11-28;2;0;0;-8.0;52803541
2022-11-28;7;6;93;5.0;52803548
2022-11-28;7;6;80;0.0;52803555
2022-11-28;4;7;78;-3.0;52803559
2022-11-28;28;27;88;24.0;52803587
2022-11-28;1;1;2;-27.0;52803588
2022-11-28;96;30;57;95.0;52803684
2022-11-28;16;17;59;-80.0;52803700
2022-11-29;10;14;62;-6.0;52803710
2022-11-29;213;164;1470;203.0;52803923
2022-11-29;0;4;4;-213.0;52803923
2022-11-29;8;10;159;8.0;52803931
2022-11-29;32;25;125;24.0;52803963
2022-11-29;19;7;205;-13.0;52803982
2022-11-29;4;3;1;-15.0;52803986
2022-11-29;47;25;101;43.0;52804033
2022-11-29;10;7;162;-37.0;52804043
2022-11-29;0;1;0;-10.0;52804043
2022-11-29;17;8;165;17.0;52804060
2022-11-29;10;6;109;-7.0;52804070
2022-11-29;18;17;154;8.0;52804088
2022-11-29;17;11;150;-1.0;52804105
2022-11-29;21;26;73;4.0;52804126
2022-11-30;12;8;102;-9.0;52804138
2022-11-30;0;0;0;-12.0;52804138
2022-11-30;7;18;4;7.0;52804145
2022-11-30;19;18;233;12.0;52804164
2022-11-30;13;9;144;-6.0;52804177
2022-11-30;12;13;78;-1.0;52804189
2022-11-30;16;21;48;4.0;52804205
2022-11-30;9;12;15;-7.0;52804214
2022-11-30;31;20;143;22.0;52804245
2022-11-30;36;25;64;5.0;52804281
2022-11-30;231;232;1273;195.0;52804512
2022-11-30;8;6;119;-223.0;52804520
2022-11-30;27;42;89;19.0;52804547
2022-11-30;11;11;130;-16.0;52804558
2022-11-30;30;29;104;19.0;52804588
2022-12-01;17;14;119;-13.0;52804605
2022-12-01;28;23;143;11.0;52804633
2022-12-01;18;14;209;-10.0;52804651
2022-12-01;240;198;1822;222.0;52804891
2022-12-01;17;8;177;-223.0;52804908
2022-12-01;25;21;258;8.0;52804933
2022-12-01;2;0;0;-23.0;52804935
2022-12-01;17;7;190;15.0;52804952
2022-12-01;0;3;5;-17.0;52804952
2022-12-01;2;3;2;2.0;52804954
2022-12-01;21;19;103;19.0;52804975
2022-12-01;23;21;195;2.0;52804998
2022-12-01;10;13;136;-13.0;52805008
2022-12-01;40;36;200;30.0;52805048
2022-12-01;20;16;85;-20.0;52805068
2022-12-02;296;241;1983;276.0;52805364
2022-12-02;0;0;0;-296.0;52805364
2022-12-02;20;16;94;20.0;52805384
2022-12-02;8;10;114;-12.0;52805392
2022-12-02;31;23;239;23.0;52805423
2022-12-02;24;14;201;-7.0;52805447
2022-12-02;25;24;125;1.0;52805472
2022-12-02;2;2;27;-23.0;52805474
2022-12-02;12;4;151;10.0;52805486
2022-12-02;21;12;182;9.0;52805507
2022-12-02;2;4;1;-19.0;52805509
2022-12-02;61;52;210;59.0;52805570
2022-12-02;33;20;328;-28.0;52805603
2022-12-02;23;18;200;-10.0;52805626
2022-12-02;34;42;111;11.0;52805660
2022-12-03;9;4;41;-25.0;52805669
2022-12-03;27;18;117;18.0;52805696
2022-12-03;6;1;48;-21.0;52805702
2022-12-03;16;9;83;10.0;52805718
2022-12-03;14;18;53;-2.0;52805732
2022-12-03;142;96;741;128.0;52805874
2022-12-03;3;5;8;-139.0;52805877
2022-12-03;2;1;3;-1.0;52805879
2022-12-03;16;13;66;14.0;52805895
2022-12-03;7;3;24;-9.0;52805902
2022-12-03;4;3;33;-3.0;52805906
2022-12-03;0;0;1;-4.0;52805906
2022-12-03;14;9;109;14.0;52805920
2022-12-03;7;3;59;-7.0;52805927
2022-12-03;17;9;96;10.0;52805944
2022-12-04;44;38;186;27.0;52805988
2022-12-04;0;0;1;-44.0;52805988
2022-12-04;0;0;14;0.0;52805988
2022-12-04;14;5;14;14.0;52806002
2022-12-04;2;4;38;-12.0;52806004
2022-12-04;4;2;13;2.0;52806008
2022-12-04;3;6;24;-1.0;52806011
2022-12-04;1;1;5;-2.0;52806012
2022-12-04;1;1;6;0.0;52806013
2022-12-04;3;2;11;2.0;52806016
2022-12-04;0;0;0;-3.0;52806016
2022-12-04;2;7;11;2.0;52806018
2022-12-04;3;1;11;1.0;52806021
2022-12-04;4;2;16;1.0;52806025
2022-12-04;7;7;22;3.0;52806032
2022-12-05;11;18;66;4.0;52806043
2022-12-05;17;6;100;6.0;52806060
2022-12-05;0;0;0;-17.0;52806060
2022-12-05;8;25;64;8.0;52806068
2022-12-05;14;5;131;6.0;52806082
2022-12-05;44;41;130;30.0;52806126
2022-12-05;32;21;264;-12.0;52806158
2022-12-05;212;221;1358;180.0;52806370
2022-12-05;10;13;141;-202.0;52806380
2022-12-05;32;24;145;22.0;52806412
2022-12-05;10;5;122;-22.0;52806422
2022-12-05;0;1;4;-10.0;52806422
2022-12-05;5;2;85;5.0;52806427
2022-12-05;27;58;106;22.0;52806454
2022-12-05;2;2;0;-25.0;52806456
2022-12-06;291;212;2182;289.0;52806747
2022-12-06;9;15;93;-282.0;52806756
2022-12-06;24;15;192;15.0;52806780
2022-12-06;1;0;0;-23.0;52806781
2022-12-06;1;3;6;0.0;52806782
2022-12-06;20;9;165;19.0;52806802
2022-12-06;19;7;253;-1.0;52806821
2022-12-06;31;24;111;12.0;52806852
2022-12-06;2;0;0;-29.0;52806854
2022-12-06;24;16;269;22.0;52806878
2022-12-06;21;25;83;-3.0;52806899
2022-12-06;26;14;261;5.0;52806925
2022-12-06;46;35;165;20.0;52806971
2022-12-06;36;29;218;-10.0;52807007
2022-12-06;31;20;366;-5.0;52807038
2022-12-07;20;19;62;-11.0;52807058
2022-12-07;31;14;162;11.0;52807089
2022-12-07;26;34;132;-5.0;52807115
2022-12-07;20;19;297;-6.0;52807135
2022-12-07;0;0;0;-20.0;52807135
2022-12-07;247;214;1676;247.0;52807382
2022-12-07;19;12;176;-228.0;52807401
2022-12-07;3;2;2;-16.0;52807404
2022-12-07;4;7;14;1.0;52807408
2022-12-07;9;9;117;5.0;52807417
2022-12-07;21;27;93;12.0;52807438
2022-12-07;22;20;177;1.0;52807460
2022-12-07;31;24;133;9.0;52807491
2022-12-07;18;8;186;-13.0;52807509
2022-12-07;23;19;125;5.0;52807532
2022-12-08;18;16;224;-5.0;52807550
2022-12-08;27;16;196;9.0;52807577
2022-12-08;3;0;2;-24.0;52807580
2022-12-08;37;29;151;34.0;52807617
2022-12-08;0;1;0;-37.0;52807617
2022-12-08;25;19;216;25.0;52807642
2022-12-08;20;17;75;-5.0;52807662
2022-12-08;259;208;2057;239.0;52807921
2022-12-08;20;10;239;-239.0;52807941
2022-12-08;16;14;159;-4.0;52807957
2022-12-08;29;28;357;13.0;52807986
2022-12-08;22;12;245;-7.0;52808008
2022-12-08;2;2;6;-20.0;52808010
2022-12-08;14;15;81;12.0;52808024
2022-12-08;26;29;106;12.0;52808050
2022-12-09;28;22;203;2.0;52808078
2022-12-09;25;15;298;-3.0;52808103
2022-12-09;22;16;194;-3.0;52808125
2022-12-09;18;8;171;-4.0;52808143
2022-12-09;49;32;306;31.0;52808192
2022-12-09;49;28;505;0.0;52808241
2022-12-09;55;38;223;6.0;52808296
2022-12-09;1;1;2;-54.0;52808297
2022-12-09;39;33;109;38.0;52808336
2022-12-09;18;12;278;-21.0;52808354
2022-12-09;27;27;97;9.0;52808381
2022-12-09;2;7;17;-25.0;52808383
2022-12-09;2;0;0;0.0;52808385
2022-12-09;355;252;2664;353.0;52808740
2022-12-09;20;13;261;-335.0;52808760
2022-12-10;2;3;0;-18.0;52808762
2022-12-10;18;26;79;16.0;52808780
2022-12-10;191;185;1214;173.0;52808971
2022-12-10;8;3;46;-183.0;52808979
2022-12-10;0;0;0;-8.0;52808979
2022-12-10;10;6;76;10.0;52808989
2022-12-10;11;9;69;1.0;52809000
2022-12-10;21;15;235;10.0;52809021
2022-12-10;2;5;29;-19.0;52809023
2022-12-10;10;5;96;8.0;52809033
2022-12-10;12;19;79;2.0;52809045
2022-12-10;26;30;134;14.0;52809071
2022-12-10;29;39;134;3.0;52809100
2022-12-10;11;6;57;-18.0;52809111
2022-12-10;31;19;180;20.0;52809142
2022-12-11;4;9;29;-27.0;52809146
2022-12-11;5;5;29;1.0;52809151
2022-12-11;0;0;15;-5.0;52809151
2022-12-11;5;3;14;5.0;52809156
2022-12-11;52;45;307;47.0;52809208
2022-12-11;3;4;17;-49.0;52809211
2022-12-11;0;0;0;-3.0;52809211
2022-12-11;1;2;7;1.0;52809212
2022-12-11;4;3;53;3.0;52809216
2022-12-11;1;0;0;-3.0;52809217
2022-12-11;2;2;15;1.0;52809219
2022-12-11;5;2;13;3.0;52809224
2022-12-11;6;5;57;1.0;52809230
2022-12-11;11;6;38;5.0;52809241
2022-12-11;5;4;20;-6.0;52809246
2022-12-12;21;17;220;16.0;52809267
2022-12-12;18;19;106;-3.0;52809285
2022-12-12;17;12;187;-1.0;52809302
2022-12-12;39;30;345;22.0;52809341
2022-12-12;12;16;95;-27.0;52809353
2022-12-12;36;22;184;24.0;52809389
2022-12-12;229;176;1939;193.0;52809618
2022-12-12;1;1;0;-228.0;52809619
2022-12-12;0;0;0;-1.0;52809619
2022-12-12;15;15;214;15.0;52809634
2022-12-12;11;8;130;-4.0;52809645
2022-12-12;1;1;7;-10.0;52809646
2022-12-12;12;8;191;11.0;52809658
2022-12-12;22;13;157;10.0;52809680
2022-12-12;24;14;103;2.0;52809704
2022-12-13;33;20;226;9.0;52809737
2022-12-13;23;16;195;-10.0;52809760
2022-12-13;20;12;278;-3.0;52809780
2022-12-13;25;14;316;5.0;52809805
2022-12-13;31;15;289;6.0;52809836
2022-12-13;43;22;486;12.0;52809879
2022-12-13;29;30;125;-14.0;52809908
2022-12-13;30;23;280;1.0;52809938
2022-12-13;24;13;132;-6.0;52809962
2022-12-13;25;13;104;1.0;52809987
2022-12-13;2;2;0;-23.0;52809989
2022-12-13;54;32;222;52.0;52810043
2022-12-13;0;0;0;-54.0;52810043
2022-12-13;2;4;18;2.0;52810045
2022-12-13;341;216;2671;339.0;52810386
2022-12-14;14;7;135;-327.0;52810400
2022-12-14;0;0;2;-14.0;52810400
2022-12-14;26;12;170;26.0;52810426
2022-12-14;28;34;166;2.0;52810454
2022-12-14;41;31;211;13.0;52810495
2022-12-14;281;237;2057;240.0;52810776
2022-12-14;16;14;203;-265.0;52810792
2022-12-14;25;15;377;9.0;52810817
2022-12-14;5;5;16;-20.0;52810822
2022-12-14;0;0;0;-5.0;52810822
2022-12-14;17;12;198;17.0;52810839
2022-12-14;20;17;73;3.0;52810859
2022-12-14;42;26;187;22.0;52810901
2022-12-14;20;13;225;-22.0;52810921
2022-12-14;27;51;94;7.0;52810948
2022-12-15;0;3;2;-27.0;52810948
2022-12-15;0;1;0;0.0;52810948
2022-12-15;3;3;9;3.0;52810951
2022-12-15;25;12;257;22.0;52810976
2022-12-15;24;24;119;-1.0;52811000
2022-12-15;17;12;175;-7.0;52811017
2022-12-15;27;21;150;10.0;52811044
2022-12-15;26;32;155;-1.0;52811070
2022-12-15;295;244;2630;269.0;52811365
2022-12-15;38;26;413;-257.0;52811403
2022-12-15;14;11;307;-24.0;52811417
2022-12-15;30;17;236;16.0;52811447
2022-12-15;38;23;303;8.0;52811485
2022-12-15;39;41;237;1.0;52811524
2022-12-15;14;18;267;-25.0;52811538
2022-12-16;50;38;315;36.0;52811588
2022-12-16;27;14;293;-23.0;52811615
2022-12-16;26;27;222;-1.0;52811641
2022-12-16;45;46;273;19.0;52811686
2022-12-16;0;0;0;-45.0;52811686
2022-12-16;25;14;291;25.0;52811711
2022-12-16;16;16;274;-9.0;52811727
2022-12-16;32;33;186;16.0;52811759
2022-12-16;28;27;243;-4.0;52811787
2022-12-16;2;7;31;-26.0;52811789
2022-12-16;18;10;188;16.0;52811807
2022-12-16;53;31;549;35.0;52811860
2022-12-16;29;29;154;-24.0;52811889
2022-12-16;3;1;1;-26.0;52811892
2022-12-16;354;293;3020;351.0;52812246
2022-12-17;0;0;0;-354.0;52812246
2022-12-17;7;9;60;7.0;52812253
2022-12-17;13;28;90;6.0;52812266
2022-12-17;148;136;1106;135.0;52812414
2022-12-17;20;11;199;-128.0;52812434
2022-12-17;8;9;99;-12.0;52812442
2022-12-17;26;20;103;18.0;52812468
2022-12-17;20;18;129;-6.0;52812488
2022-12-17;9;8;64;-11.0;52812497
2022-12-17;24;16;190;15.0;52812521
2022-12-17;7;4;54;-17.0;52812528
2022-12-17;10;6;54;3.0;52812538
2022-12-17;2;2;35;-8.0;52812540
2022-12-17;1;1;4;-1.0;52812541
2022-12-17;1;4;25;0.0;52812542
2022-12-18;6;4;67;5.0;52812548
2022-12-18;2;1;7;-4.0;52812550
2022-12-18;5;5;18;3.0;52812555
2022-12-18;42;35;276;37.0;52812597
2022-12-18;1;0;0;-41.0;52812598
2022-12-18;2;3;11;1.0;52812600
2022-12-18;2;1;12;0.0;52812602
2022-12-18;1;1;4;-1.0;52812603
2022-12-18;3;2;44;2.0;52812606
2022-12-18;6;6;25;3.0;52812612
2022-12-18;5;4;17;-1.0;52812617
2022-12-18;2;1;14;-3.0;52812619
2022-12-18;0;0;0;-2.0;52812619
2022-12-18;0;0;23;0.0;52812619
2022-12-18;7;7;34;7.0;52812626
2022-12-19;9;9;66;2.0;52812635
2022-12-19;35;38;105;26.0;52812670
2022-12-19;33;32;249;-2.0;52812703
2022-12-19;1;1;1;-32.0;52812704
2022-12-19;28;24;296;27.0;52812732
2022-12-19;21;19;76;-7.0;52812753
2022-12-19;0;0;0;-21.0;52812753
2022-12-19;2;5;22;2.0;52812755
2022-12-19;42;24;164;40.0;52812797
2022-12-19;15;7;149;-27.0;52812812
2022-12-19;21;7;149;6.0;52812833
2022-12-19;21;8;121;0.0;52812854
2022-12-19;15;10;118;-6.0;52812869
2022-12-19;34;26;185;19.0;52812903
2022-12-19;277;210;1701;243.0;52813180
2022-12-20;19;9;105;-258.0;52813199
2022-12-20;0;0;0;-19.0;52813199
2022-12-20;18;10;193;18.0;52813217
2022-12-20;40;23;115;22.0;52813257
2022-12-20;20;13;182;-20.0;52813277
2022-12-20;55;29;224;35.0;52813332
2022-12-20;0;1;0;-55.0;52813332
2022-12-20;23;17;187;23.0;52813355
2022-12-20;39;37;277;16.0;52813394
2022-12-20;360;236;2426;321.0;52813754
2022-12-20;38;18;446;-322.0;52813792
2022-12-20;31;15;239;-7.0;52813823
2022-12-20;38;34;137;7.0;52813861
2022-12-20;1;3;23;-37.0;52813862
2022-12-20;38;27;298;37.0;52813900
2022-12-21;15;12;100;-23.0;52813915
2022-12-21;22;20;80;7.0;52813937
2022-12-21;9;4;89;-13.0;52813946
2022-12-21;14;6;142;5.0;52813960
2022-12-21;0;0;0;-14.0;52813960
2022-12-21;51;29;144;51.0;52814011
2022-12-21;13;11;157;-38.0;52814024
2022-12-21;0;0;1;-13.0;52814024
2022-12-21;23;16;156;23.0;52814047
2022-12-21;21;18;298;-2.0;52814068
2022-12-21;38;27;98;17.0;52814106
2022-12-21;274;192;1668;236.0;52814380
2022-12-21;32;14;162;-242.0;52814412
2022-12-21;33;31;217;1.0;52814445
2022-12-21;3;4;24;-30.0;52814448
2022-12-22;32;25;119;29.0;52814480
2022-12-22;0;0;0;-32.0;52814480
2022-12-22;32;32;183;32.0;52814512
2022-12-22;9;7;93;-23.0;52814521
2022-12-22;16;12;144;7.0;52814537
2022-12-22;22;17;153;6.0;52814559
2022-12-22;1;3;22;-21.0;52814560
2022-12-22;45;27;171;44.0;52814605
2022-12-22;25;24;70;-20.0;52814630
2022-12-22;17;10;143;-8.0;52814647
2022-12-22;34;36;156;17.0;52814681
2022-12-22;299;230;1673;265.0;52814980
2022-12-22;0;3;3;-299.0;52814980
2022-12-22;34;25;283;34.0;52815014
2022-12-22;32;9;133;-2.0;52815046
2022-12-23;31;24;237;-1.0;52815077
2022-12-23;28;15;147;-3.0;52815105
2022-12-23;5;7;64;-23.0;52815110
2022-12-23;9;9;88;4.0;52815119
2022-12-23;17;20;155;8.0;52815136
2022-12-23;34;26;170;17.0;52815170
2022-12-23;18;17;90;-16.0;52815188
2022-12-23;0;0;0;-18.0;52815188
2022-12-23;4;3;47;4.0;52815192
2022-12-23;1;2;3;-3.0;52815193
2022-12-23;18;18;77;17.0;52815211
2022-12-23;40;28;160;22.0;52815251
2022-12-23;4;4;12;-36.0;52815255
2022-12-23;13;12;76;9.0;52815268
2022-12-23;222;185;1326;209.0;52815490
2022-12-24;8;8;17;-214.0;52815498
2022-12-24;5;4;36;-3.0;52815503
2022-12-24;7;3;19;2.0;52815510
2022-12-24;0;0;0;-7.0;52815510
2022-12-24;2;0;12;2.0;52815512
2022-12-24;6;9;21;4.0;52815518
2022-12-24;2;1;10;-4.0;52815520
2022-12-24;4;2;5;2.0;52815524
2022-12-24;5;5;21;1.0;52815529
2022-12-24;6;4;27;1.0;52815535
2022-12-24;0;0;0;-6.0;52815535
2022-12-24;0;1;3;0.0;52815535
2022-12-24;0;0;8;0.0;52815535
2022-12-24;45;39;182;45.0;52815580
2022-12-24;0;2;3;-45.0;52815580
2022-12-25;3;2;5;3.0;52815583
2022-12-25;23;22;58;20.0;52815606
2022-12-25;4;6;7;-19.0;52815610
2022-12-25;0;0;0;-4.0;52815610
2022-12-25;1;0;2;1.0;52815611
2022-12-25;2;2;9;1.0;52815613
2022-12-25;0;0;5;-2.0;52815613
2022-12-25;0;0;3;0.0;52815613
2022-12-25;2;1;6;2.0;52815615
2022-12-25;0;2;1;-2.0;52815615
2022-12-25;0;0;1;0.0;52815615
2022-12-25;6;6;9;6.0;52815621
2022-12-25;0;0;2;-6.0;52815621
2022-12-25;2;1;2;2.0;52815623
2022-12-25;3;2;6;1.0;52815626
2022-12-26;1;2;14;-2.0;52815627
2022-12-26;1;1;0;0.0;52815628
2022-12-26;29;22;112;28.0;52815657
2022-12-26;26;21;101;-3.0;52815683
2022-12-26;23;16;128;-3.0;52815706
2022-12-26;10;8;40;-13.0;52815716
2022-12-26;5;1;31;-5.0;52815721
2022-12-26;17;13;70;12.0;52815738
2022-12-26;14;14;153;-3.0;52815752
2022-12-26;8;6;45;-6.0;52815760
2022-12-26;0;1;1;-8.0;52815760
2022-12-26;8;8;30;8.0;52815768
2022-12-26;23;18;102;15.0;52815791
2022-12-26;10;3;39;-13.0;52815801
2022-12-26;175;134;866;165.0;52815976
2022-12-27;24;25;206;-151.0;52816000
2022-12-27;17;3;77;-7.0;52816017
2022-12-27;27;23;167;10.0;52816044
2022-12-27;23;26;129;-4.0;52816067
2022-12-27;21;19;89;-2.0;52816088
2022-12-27;19;15;89;-2.0;52816107
2022-12-27;1;3;30;-18.0;52816108
2022-12-27;1;1;1;0.0;52816109
2022-12-27;14;9;91;13.0;52816123
2022-12-27;12;7;85;-2.0;52816135
2022-12-27;32;19;225;20.0;52816167
2022-12-27;10;7;66;-22.0;52816177
2022-12-27;232;187;1385;222.0;52816409
2022-12-27;30;30;129;-202.0;52816439
2022-12-27;1;0;1;-29.0;52816440
2022-12-28;32;22;120;31.0;52816472
2022-12-28;21;18;105;-11.0;52816493
2022-12-28;20;8;78;-1.0;52816513
2022-12-28;10;6;58;-10.0;52816523
2022-12-28;4;3;17;-6.0;52816527
2022-12-28;9;3;52;5.0;52816536
2022-12-28;14;9;63;5.0;52816550
2022-12-28;0;2;1;-14.0;52816550
2022-12-28;14;1;37;14.0;52816564
2022-12-28;20;15;175;6.0;52816584
2022-12-28;24;24;148;4.0;52816608
2022-12-28;26;21;72;2.0;52816634
2022-12-28;0;2;1;-26.0;52816634
2022-12-28;216;154;1093;216.0;52816850
2022-12-28;22;20;166;-194.0;52816872
2022-12-29;18;25;83;-4.0;52816890
2022-12-29;10;5;43;-8.0;52816900
2022-12-29;0;1;2;-10.0;52816900
2022-12-29;21;20;131;21.0;52816921
2022-12-29;8;7;78;-13.0;52816929
2022-12-29;20;11;195;12.0;52816949
2022-12-29;33;29;119;13.0;52816982
2022-12-29;20;19;67;-13.0;52817002
2022-12-29;16;14;61;-4.0;52817018
2022-12-29;23;10;210;7.0;52817041
2022-12-29;7;4;62;-16.0;52817048
2022-12-29;3;4;25;-4.0;52817051
2022-12-29;0;0;0;-3.0;52817051
2022-12-29;15;9;74;15.0;52817066
2022-12-29;194;158;1150;179.0;52817260
2022-12-30;9;5;65;-185.0;52817269
2022-12-30;2;0;0;-7.0;52817271
2022-12-30;6;2;55;4.0;52817277
2022-12-30;3;4;33;-3.0;52817280
2022-12-30;16;15;55;13.0;52817296
2022-12-30;199;152;876;183.0;52817495
2022-12-30;34;33;93;-165.0;52817529
2022-12-30;0;3;26;-34.0;52817529
2022-12-30;25;27;59;25.0;52817554
2022-12-30;29;18;95;4.0;52817583
2022-12-30;27;14;152;-2.0;52817610
2022-12-30;4;3;35;-23.0;52817614
2022-12-30;13;8;52;9.0;52817627
2022-12-30;1;2;0;-12.0;52817628
2022-12-30;30;18;156;29.0;52817658
2022-12-31;0;2;9;-30.0;52817658
2022-12-31;11;9;37;11.0;52817669
2022-12-31;0;0;0;-11.0;52817669
2022-12-31;8;13;34;8.0;52817677
2022-12-31;0;0;0;-8.0;52817677
2022-12-31;4;3;9;4.0;52817681
2022-12-31;5;4;11;1.0;52817686
2022-12-31;3;3;5;-2.0;52817689
2022-12-31;59;58;200;56.0;52817748
2022-12-31;3;5;19;-56.0;52817751
2022-12-31;2;0;9;-1.0;52817753
2022-12-31;4;5;21;2.0;52817757
2022-12-31;7;4;9;3.0;52817764
2022-12-31;3;1;12;-4.0;52817767
2022-12-31;9;9;25;6.0;52817776
2023-01-01;0;0;1;-9.0;52817776
2023-01-01;13;12;79;13.0;52817789
2023-01-01;0;1;1;-13.0;52817789
2023-01-01;1;0;5;1.0;52817790
2023-01-01;0;0;4;-1.0;52817790
2023-01-01;4;3;17;4.0;52817794
2023-01-01;0;0;1;-4.0;52817794
2023-01-01;0;0;0;0.0;52817794
2023-01-01;1;0;8;1.0;52817795
2023-01-01;1;1;15;0.0;52817796
2023-01-01;1;2;7;0.0;52817797
2023-01-01;0;2;4;-1.0;52817797
2023-01-01;0;0;0;0.0;52817797
2023-01-01;4;3;14;4.0;52817801
2023-01-01;1;0;2;-3.0;52817802
2023-01-02;78;37;158;77.0;52817880
2023-01-02;31;20;149;-47.0;52817911
2023-01-02;22;7;56;-9.0;52817933
2023-01-02;108;46;165;86.0;52818041
2023-01-02;2;1;2;-106.0;52818043
2023-01-02;466;203;1068;464.0;52818509
2023-01-02;0;0;1;-466.0;52818509
2023-01-02;84;31;118;84.0;52818593
2023-01-02;54;20;124;-30.0;52818647
2023-01-02;6;6;19;-48.0;52818653
2023-01-02;7;4;27;1.0;52818660
2023-01-02;9;5;45;2.0;52818669
2023-01-02;45;23;134;36.0;52818714
2023-01-02;18;2;53;-27.0;52818732
2023-01-02;2;1;17;-16.0;52818734
2023-01-03;42;23;200;40.0;52818776
2023-01-03;84;29;135;42.0;52818860
2023-01-03;0;0;0;-84.0;52818860
2023-01-03;12;4;64;12.0;52818872
2023-01-03;343;211;1555;331.0;52819215
2023-01-03;22;12;121;-321.0;52819237
2023-01-03;2;0;1;-20.0;52819239
2023-01-03;39;37;251;37.0;52819278
2023-01-03;14;15;125;-25.0;52819292
2023-01-03;1;0;4;-13.0;52819293
2023-01-03;4;5;98;3.0;52819297
2023-01-03;57;42;178;53.0;52819354
2023-01-03;19;12;145;-38.0;52819373
2023-01-03;35;21;101;16.0;52819408
2023-01-03;12;11;132;-23.0;52819420
2023-01-04;36;27;147;24.0;52819456
2023-01-04;264;182;1252;228.0;52819720
2023-01-04;27;22;87;-237.0;52819747
2023-01-04;2;0;1;-25.0;52819749
2023-01-04;8;6;59;6.0;52819757
2023-01-04;14;11;105;6.0;52819771
2023-01-04;0;0;0;-14.0;52819771
2023-01-04;31;25;106;31.0;52819802
2023-01-04;45;40;139;14.0;52819847
2023-01-04;9;4;87;-36.0;52819856
2023-01-04;28;20;143;19.0;52819884
2023-01-04;12;5;88;-16.0;52819896
2023-01-04;4;1;17;-8.0;52819900
2023-01-04;32;12;210;28.0;52819932
2023-01-04;16;9;63;-16.0;52819948
2023-01-05;15;11;91;-1.0;52819963
2023-01-05;9;9;77;-6.0;52819972
2023-01-05;17;17;133;8.0;52819989
2023-01-05;34;37;175;17.0;52820023
2023-01-05;29;29;75;-5.0;52820052
2023-01-05;18;9;133;-11.0;52820070
2023-01-05;54;33;114;36.0;52820124
2023-01-05;21;24;302;-33.0;52820145
2023-01-05;61;50;152;40.0;52820206
2023-01-05;302;263;1511;241.0;52820508
2023-01-05;1;2;10;-301.0;52820509
2023-01-05;0;2;2;-1.0;52820509
2023-01-05;16;20;103;16.0;52820525
2023-01-05;27;19;144;11.0;52820552
2023-01-05;0;1;0;-27.0;52820552
2023-01-06;37;26;196;37.0;52820589
2023-01-06;2;4;27;-35.0;52820591
2023-01-06;47;44;131;45.0;52820638
2023-01-06;41;27;96;-6.0;52820679
2023-01-06;11;8;89;-30.0;52820690
2023-01-06;17;9;158;6.0;52820707
2023-01-06;33;24;258;16.0;52820740
2023-01-06;1;1;2;-32.0;52820741
2023-01-06;10;15;86;9.0;52820751
2023-01-06;21;10;125;11.0;52820772
2023-01-06;31;17;122;10.0;52820803
2023-01-06;38;22;195;7.0;52820841
2023-01-06;367;254;1665;329.0;52821208
2023-01-06;76;47;180;-291.0;52821284
2023-01-06;2;0;0;-74.0;52821286
2023-01-07;5;5;24;3.0;52821291
2023-01-07;20;19;63;15.0;52821311
2023-01-07;14;20;45;-6.0;52821325
2023-01-07;160;140;618;146.0;52821485
2023-01-07;2;2;31;-158.0;52821487
2023-01-07;2;4;1;0.0;52821489
2023-01-07;6;5;15;4.0;52821495
2023-01-07;29;21;116;23.0;52821524
2023-01-07;0;3;23;-29.0;52821524
2023-01-07;19;16;90;19.0;52821543
2023-01-07;0;0;0;-19.0;52821543
2023-01-07;20;15;74;20.0;52821563
2023-01-07;4;4;22;-16.0;52821567
2023-01-07;11;1;30;7.0;52821578
2023-01-07;28;25;84;17.0;52821606
2023-01-08;3;0;12;-25.0;52821609
2023-01-08;0;3;3;-3.0;52821609
2023-01-08;6;3;22;6.0;52821615
2023-01-08;13;16;26;7.0;52821628
2023-01-08;0;1;2;-13.0;52821628
2023-01-08;5;4;20;5.0;52821633
2023-01-08;53;46;161;48.0;52821686
2023-01-08;9;4;14;-44.0;52821695
2023-01-08;4;6;25;-5.0;52821699
2023-01-08;0;0;0;-4.0;52821699
2023-01-08;6;5;13;6.0;52821705
2023-01-08;1;1;5;-5.0;52821706
2023-01-08;4;3;6;3.0;52821710
2023-01-08;1;0;6;-3.0;52821711
2023-01-08;1;0;7;0.0;52821712
2023-01-09;23;11;76;22.0;52821735
2023-01-09;4;9;53;-19.0;52821739
2023-01-09;51;31;111;47.0;52821790
2023-01-09;49;63;104;-2.0;52821839
2023-01-09;17;12;54;-32.0;52821856
2023-01-09;14;9;69;-3.0;52821870
2023-01-09;0;2;6;-14.0;52821870
2023-01-09;0;0;2;0.0;52821870
2023-01-09;273;221;908;273.0;52822143
2023-01-09;37;28;135;-236.0;52822180
2023-01-09;1;0;1;-36.0;52822181
2023-01-09;11;6;58;10.0;52822192
2023-01-09;31;28;138;20.0;52822223
2023-01-09;32;19;70;1.0;52822255
2023-01-09;3;3;31;-29.0;52822258
2023-01-10;21;12;126;18.0;52822279
2023-01-10;44;32;201;23.0;52822323
2023-01-10;29;30;282;-15.0;52822352
2023-01-10;7;10;117;-22.0;52822359
2023-01-10;34;51;140;27.0;52822393
2023-01-10;57;56;174;23.0;52822450
2023-01-10;18;14;127;-39.0;52822468
2023-01-10;287;281;1602;269.0;52822755
2023-01-10;11;11;115;-276.0;52822766
2023-01-10;29;22;113;18.0;52822795
2023-01-10;2;1;10;-27.0;52822797
2023-01-10;8;6;65;6.0;52822805
2023-01-10;27;35;130;19.0;52822832
2023-01-10;0;0;0;-27.0;52822832
2023-01-10;0;1;2;0.0;52822832
2023-01-11;38;40;91;38.0;52822870
2023-01-11;14;9;91;-24.0;52822884
2023-01-11;4;6;14;-10.0;52822888
2023-01-11;3;2;1;-1.0;52822891
2023-01-11;25;23;59;22.0;52822916
2023-01-11;1;0;0;-24.0;52822917
2023-01-11;8;3;43;7.0;52822925
2023-01-11;20;19;143;12.0;52822945
2023-01-11;10;8;88;-10.0;52822955
2023-01-11;206;197;1056;196.0;52823161
2023-01-11;20;24;89;-186.0;52823181
2023-01-11;11;5;84;-9.0;52823192
2023-01-11;20;30;125;9.0;52823212
2023-01-11;29;22;151;9.0;52823241
2023-01-11;3;6;77;-26.0;52823244
2023-01-12;0;1;0;-3.0;52823244
2023-01-12;37;45;127;37.0;52823281
2023-01-12;23;15;89;-14.0;52823304
2023-01-12;38;21;189;15.0;52823342
2023-01-12;12;10;99;-26.0;52823354
2023-01-12;13;10;49;1.0;52823367
2023-01-12;29;20;73;16.0;52823396
2023-01-12;18;15;107;-11.0;52823414
2023-01-12;3;2;3;-15.0;52823417
2023-01-12;5;2;12;2.0;52823422
2023-01-12;36;37;182;31.0;52823458
2023-01-12;13;7;100;-23.0;52823471
2023-01-12;296;221;1295;283.0;52823767
2023-01-12;14;6;92;-282.0;52823781
2023-01-12;55;30;173;41.0;52823836
2023-01-13;10;11;82;-45.0;52823846
2023-01-13;36;26;181;26.0;52823882
2023-01-13;49;26;130;13.0;52823931
2023-01-13;17;6;14;-32.0;52823948
2023-01-13;55;45;167;38.0;52824003
2023-01-13;12;8;11;-43.0;52824015
2023-01-13;29;19;114;17.0;52824044
2023-01-13;41;29;201;12.0;52824085
2023-01-13;48;30;81;7.0;52824133
2023-01-13;378;237;1442;330.0;52824511
2023-01-13;3;4;50;-375.0;52824514
2023-01-13;0;0;0;-3.0;52824514
2023-01-13;20;7;91;20.0;52824534
2023-01-13;16;7;68;-4.0;52824550
2023-01-13;42;19;252;26.0;52824592
2023-01-14;1;2;15;-41.0;52824593
2023-01-14;19;9;14;18.0;52824612
2023-01-14;0;0;2;-19.0;52824612
2023-01-14;3;2;20;3.0;52824615
2023-01-14;20;11;72;17.0;52824635
2023-01-14;10;7;10;-10.0;52824645
2023-01-14;23;11;122;13.0;52824668
2023-01-14;22;10;84;-1.0;52824690
2023-01-14;5;2;26;-17.0;52824695
2023-01-14;21;10;61;16.0;52824716
2023-01-14;20;17;74;-1.0;52824736
2023-01-14;13;14;34;-7.0;52824749
2023-01-14;164;100;581;151.0;52824913
2023-01-14;1;2;25;-163.0;52824914
2023-01-14;6;3;22;5.0;52824920
2023-01-15;6;4;23;0.0;52824926
2023-01-15;45;43;142;39.0;52824971
2023-01-15;4;4;2;-41.0;52824975
2023-01-15;5;3;13;1.0;52824980
2023-01-15;4;2;3;-1.0;52824984
2023-01-15;1;0;6;-3.0;52824985
2023-01-15;0;0;2;-1.0;52824985
2023-01-15;1;1;9;1.0;52824986
2023-01-15;9;8;23;8.0;52824995
2023-01-15;1;1;3;-8.0;52824996
2023-01-15;0;0;1;-1.0;52824996
2023-01-15;3;8;15;3.0;52824999
2023-01-15;7;7;27;4.0;52825006
2023-01-15;0;0;0;-7.0;52825006
2023-01-15;4;5;15;4.0;52825010
2023-01-16;4;5;30;0.0;52825014
2023-01-16;6;6;2;2.0;52825020
2023-01-16;15;14;70;9.0;52825035
2023-01-16;0;0;0;-15.0;52825035
2023-01-16;14;13;75;14.0;52825049
2023-01-16;7;6;43;-7.0;52825056
2023-01-16;17;17;113;10.0;52825073
2023-01-16;26;26;101;9.0;52825099
2023-01-16;13;4;47;-13.0;52825112
2023-01-16;182;159;808;169.0;52825294
2023-01-16;32;34;136;-150.0;52825326
2023-01-16;12;9;51;-20.0;52825338
2023-01-16;3;0;5;-9.0;52825341
2023-01-16;8;9;51;5.0;52825349
2023-01-16;25;16;84;17.0;52825374
2023-01-17;215;167;1121;190.0;52825589
2023-01-17;15;11;110;-200.0;52825604
2023-01-17;18;14;59;3.0;52825622
2023-01-17;21;11;81;3.0;52825643
2023-01-17;25;18;127;4.0;52825668
2023-01-17;1;0;0;-24.0;52825669
2023-01-17;18;13;83;17.0;52825687
2023-01-17;29;30;141;11.0;52825716
2023-01-17;3;5;73;-26.0;52825719
2023-01-17;30;30;144;27.0;52825749
2023-01-17;4;3;1;-26.0;52825753
2023-01-17;4;2;8;0.0;52825757
2023-01-17;30;16;179;26.0;52825787
2023-01-17;10;7;55;-20.0;52825797
2023-01-17;7;7;60;-3.0;52825804
2023-01-18;21;15;90;14.0;52825825
2023-01-18;20;14;120;-1.0;52825845
2023-01-18;0;0;0;-20.0;52825845
2023-01-18;24;17;52;24.0;52825869
2023-01-18;6;5;59;-18.0;52825875
2023-01-18;16;15;9;10.0;52825891
2023-01-18;6;4;30;-10.0;52825897
2023-01-18;224;181;802;218.0;52826121
2023-01-18;9;7;37;-215.0;52826130
2023-01-18;21;15;17;12.0;52826151
2023-01-18;25;28;109;4.0;52826176
2023-01-18;9;6;45;-16.0;52826185
2023-01-18;28;22;94;19.0;52826213
2023-01-18;12;8;55;-16.0;52826225
2023-01-18;27;25;85;15.0;52826252
2023-01-19;222;150;945;195.0;52826474
2023-01-19;24;15;87;-198.0;52826498
2023-01-19;29;16;161;5.0;52826527
2023-01-19;10;7;53;-19.0;52826537
2023-01-19;15;11;112;5.0;52826552
2023-01-19;13;10;63;-2.0;52826565
2023-01-19;22;17;68;9.0;52826587
2023-01-19;44;32;96;22.0;52826631
2023-01-19;0;0;1;-44.0;52826631
2023-01-19;26;15;99;26.0;52826657
2023-01-19;10;5;52;-16.0;52826667
2023-01-19;8;7;73;-2.0;52826675
2023-01-19;4;1;7;-4.0;52826679
2023-01-19;12;12;66;8.0;52826691
2023-01-19;5;2;7;-7.0;52826696
2023-01-20;9;4;14;4.0;52826705
2023-01-20;38;24;98;29.0;52826743
2023-01-20;45;29;127;7.0;52826788
2023-01-20;8;6;35;-37.0;52826796
2023-01-20;15;15;78;7.0;52826811
2023-01-20;11;10;59;-4.0;52826822
2023-01-20;5;5;11;-6.0;52826827
2023-01-20;12;5;70;7.0;52826839
2023-01-20;25;24;62;13.0;52826864
2023-01-20;9;10;97;-16.0;52826873
2023-01-20;31;35;154;22.0;52826904
2023-01-20;0;0;1;-31.0;52826904
2023-01-20;45;41;136;45.0;52826949
2023-01-20;21;19;214;-24.0;52826970
2023-01-20;274;227;1156;253.0;52827244
2023-01-21;15;8;49;-259.0;52827259
2023-01-21;1;0;0;-14.0;52827260
2023-01-21;4;7;16;3.0;52827264
2023-01-21;9;8;59;5.0;52827273
2023-01-21;18;10;35;9.0;52827291
2023-01-21;4;4;22;-14.0;52827295
2023-01-21;108;99;390;104.0;52827403
2023-01-21;8;5;51;-100.0;52827411
2023-01-21;4;3;9;-4.0;52827415
2023-01-21;10;22;79;6.0;52827425
2023-01-21;2;1;8;-8.0;52827427
2023-01-21;2;2;12;0.0;52827429
2023-01-21;11;6;10;9.0;52827440
2023-01-21;6;11;7;-5.0;52827446
2023-01-21;14;12;33;8.0;52827460
2023-01-22;4;0;3;-10.0;52827464
2023-01-22;0;0;3;-4.0;52827464
2023-01-22;0;0;0;0.0;52827464
2023-01-22;1;3;11;1.0;52827465
2023-01-22;4;5;12;3.0;52827469
2023-01-22;22;20;67;18.0;52827491
2023-01-22;1;1;9;-21.0;52827492
2023-01-22;2;2;6;1.0;52827494
2023-01-22;0;1;3;-2.0;52827494
2023-01-22;1;1;3;1.0;52827495
2023-01-22;2;1;2;1.0;52827497
2023-01-22;1;1;5;-1.0;52827498
2023-01-22;2;2;6;1.0;52827500
2023-01-22;2;1;3;0.0;52827502
2023-01-22;2;2;1;0.0;52827504
2023-01-23;145;115;571;143.0;52827649
2023-01-23;22;17;76;-123.0;52827671
2023-01-23;15;14;49;-7.0;52827686
2023-01-23;1;2;3;-14.0;52827687
2023-01-23;7;8;22;6.0;52827694
2023-01-23;4;1;39;-3.0;52827698
2023-01-23;18;15;73;14.0;52827716
2023-01-23;7;7;30;-11.0;52827723
2023-01-23;18;9;83;11.0;52827741
2023-01-23;16;16;50;-2.0;52827757
2023-01-23;24;16;86;8.0;52827781
2023-01-23;8;5;34;-16.0;52827789
2023-01-23;0;0;0;-8.0;52827789
2023-01-23;1;3;4;1.0;52827790
2023-01-23;4;2;22;3.0;52827794
2023-01-24;7;2;7;3.0;52827801
2023-01-24;3;5;62;-4.0;52827804
2023-01-24;2;7;37;-1.0;52827806
2023-01-24;46;36;106;44.0;52827852
2023-01-24;9;10;59;-37.0;52827861
2023-01-24;22;19;154;13.0;52827883
2023-01-24;4;0;0;-18.0;52827887
2023-01-24;18;21;65;14.0;52827905
2023-01-24;13;11;71;-5.0;52827918
2023-01-24;16;14;79;3.0;52827934
2023-01-24;1;0;0;-15.0;52827935
2023-01-24;10;1;51;9.0;52827945
2023-01-24;206;166;862;196.0;52828151
2023-01-24;26;19;96;-180.0;52828177
2023-01-24;29;21;75;3.0;52828206
2023-01-25;0;0;0;-29.0;52828206
2023-01-25;3;9;34;3.0;52828209
2023-01-25;174;200;652;171.0;52828383
2023-01-25;3;4;11;-171.0;52828386
2023-01-25;20;25;82;17.0;52828406
2023-01-25;8;5;40;-12.0;52828414
2023-01-25;11;9;20;3.0;52828425
2023-01-25;7;4;21;-4.0;52828432
2023-01-25;33;54;54;26.0;52828465
2023-01-25;19;16;103;-14.0;52828484
2023-01-25;18;15;58;-1.0;52828502
2023-01-25;16;17;40;-2.0;52828518
2023-01-25;8;4;42;-8.0;52828526
2023-01-25;8;7;51;0.0;52828534
2023-01-25;20;31;96;12.0;52828554
2023-01-26;11;17;73;-9.0;52828565
2023-01-26;8;12;59;-3.0;52828573
2023-01-26;171;167;729;163.0;52828744
2023-01-26;2;1;2;-169.0;52828746
2023-01-26;18;19;46;16.0;52828764
2023-01-26;6;8;48;-12.0;52828770
2023-01-26;2;2;6;-4.0;52828772
2023-01-26;2;4;28;0.0;52828774
2023-01-26;0;0;0;-2.0;52828774
2023-01-26;29;19;92;29.0;52828803
2023-01-26;32;26;76;3.0;52828835
2023-01-26;28;27;86;-4.0;52828863
2023-01-26;9;12;51;-19.0;52828872
2023-01-26;10;9;43;1.0;52828882
2023-01-26;14;11;119;4.0;52828896
2023-01-27;6;10;60;-8.0;52828902
2023-01-27;5;4;29;-1.0;52828907
2023-01-27;0;0;0;-5.0;52828907
2023-01-27;36;54;129;36.0;52828943
2023-01-27;9;23;51;-27.0;52828952
2023-01-27;10;12;8;1.0;52828962
2023-01-27;20;65;63;10.0;52828982
2023-01-27;234;461;863;214.0;52829216
2023-01-27;39;93;93;-195.0;52829255
2023-01-27;26;79;89;-13.0;52829281
2023-01-27;6;4;4;-20.0;52829287
2023-01-27;7;8;40;1.0;52829294
2023-01-27;38;67;99;31.0;52829332
2023-01-27;8;12;42;-30.0;52829340
2023-01-27;24;30;156;16.0;52829364
2023-01-28;4;13;21;-20.0;52829368
2023-01-28;0;0;0;-4.0;52829368
2023-01-28;12;7;35;12.0;52829380
2023-01-28;1;2;14;-11.0;52829381
2023-01-28;19;12;38;18.0;52829400
2023-01-28;5;2;6;-14.0;52829405
2023-01-28;22;14;25;17.0;52829427
2023-01-28;111;105;280;89.0;52829538
2023-01-28;4;4;12;-107.0;52829542
2023-01-28;19;19;37;15.0;52829561
2023-01-28;2;1;16;-17.0;52829563
2023-01-28;13;24;62;11.0;52829576
2023-01-28;0;0;3;-13.0;52829576
2023-01-28;5;4;2;5.0;52829581
2023-01-28;5;3;9;0.0;52829586
2023-01-29;0;0;1;-5.0;52829586
2023-01-29;1;2;3;1.0;52829587
2023-01-29;19;26;41;18.0;52829606
2023-01-29;2;6;6;-17.0;52829608
2023-01-29;2;3;7;0.0;52829610
2023-01-29;0;0;1;-2.0;52829610
2023-01-29;1;1;0;1.0;52829611
2023-01-29;5;4;4;4.0;52829616
2023-01-29;4;8;7;-1.0;52829620
2023-01-29;0;0;0;-4.0;52829620
2023-01-29;1;0;1;1.0;52829621
2023-01-29;1;0;2;0.0;52829622
2023-01-29;1;2;6;0.0;52829623
2023-01-29;0;0;2;-1.0;52829623
2023-01-29;1;0;1;1.0;52829624
2023-01-30;4;4;25;3.0;52829628
2023-01-30;1;2;2;-3.0;52829629
2023-01-30;15;18;44;14.0;52829644
2023-01-30;2;1;3;-13.0;52829646
2023-01-30;3;1;25;1.0;52829649
2023-01-30;66;25;53;63.0;52829715
2023-01-30;0;0;0;-66.0;52829715
2023-01-30;5;5;13;5.0;52829720
2023-01-30;6;9;64;1.0;52829726
2023-01-30;171;144;474;165.0;52829897
2023-01-30;23;28;65;-148.0;52829920
2023-01-30;8;5;28;-15.0;52829928
2023-01-30;11;15;58;3.0;52829939
2023-01-30;8;6;33;-3.0;52829947
2023-01-30;19;25;61;11.0;52829966
2023-01-31;7;7;46;-12.0;52829973
2023-01-31;7;4;37;0.0;52829980
2023-01-31;187;150;680;180.0;52830167
2023-01-31;19;15;45;-168.0;52830186
2023-01-31;11;10;54;-8.0;52830197
2023-01-31;0;2;0;-11.0;52830197
2023-01-31;0;0;0;0.0;52830197
2023-01-31;12;6;35;12.0;52830209
2023-01-31;20;21;93;8.0;52830229
2023-01-31;46;19;64;26.0;52830275
2023-01-31;28;30;92;-18.0;52830303
2023-01-31;1;3;4;-27.0;52830304
2023-01-31;8;4;20;7.0;52830312
2023-01-31;21;18;113;13.0;52830333
2023-01-31;7;11;77;-14.0;52830340
2023-02-01;26;24;72;19.0;52830366
2023-02-01;184;177;653;158.0;52830550
2023-02-01;9;4;6;-175.0;52830559
2023-02-01;4;4;7;-5.0;52830563
2023-02-01;14;23;68;10.0;52830577
2023-02-01;4;7;27;-10.0;52830581
2023-02-01;10;6;32;6.0;52830591
2023-02-01;5;2;19;-5.0;52830596
2023-02-01;15;15;76;10.0;52830611
2023-02-01;5;4;25;-10.0;52830616
2023-02-01;27;44;130;22.0;52830643
2023-02-01;34;24;87;7.0;52830677
2023-02-01;0;0;0;-34.0;52830677
2023-02-01;6;3;20;6.0;52830683
2023-02-01;25;17;84;19.0;52830708
2023-02-02;36;25;73;11.0;52830744
2023-02-02;2;1;4;-34.0;52830746
2023-02-02;20;15;81;18.0;52830766
2023-02-02;4;3;36;-16.0;52830770
2023-02-02;6;6;39;2.0;52830776
2023-02-02;2;2;0;-4.0;52830778
2023-02-02;13;15;26;11.0;52830791
2023-02-02;17;18;61;4.0;52830808
2023-02-02;2;7;33;-15.0;52830810
2023-02-02;28;26;92;26.0;52830838
2023-02-02;5;7;40;-23.0;52830843
2023-02-02;18;17;79;13.0;52830861
2023-02-02;4;10;56;-14.0;52830865
2023-02-02;0;0;0;-4.0;52830865
2023-02-02;157;152;620;157.0;52831022
2023-02-03;4;10;12;-153.0;52831026
2023-02-03;5;5;29;1.0;52831031
2023-02-03;5;8;2;0.0;52831036
2023-02-03;44;36;111;39.0;52831080
2023-02-03;3;9;44;-41.0;52831083
2023-02-03;35;30;82;32.0;52831118
2023-02-03;36;26;92;1.0;52831154
2023-02-03;0;1;0;-36.0;52831154
2023-02-03;1;3;32;1.0;52831155
2023-02-03;26;37;104;25.0;52831181
2023-02-03;204;222;734;178.0;52831385
2023-02-03;21;22;104;-183.0;52831406
2023-02-03;2;3;29;-19.0;52831408
2023-02-03;2;10;30;0.0;52831410
2023-02-03;20;22;63;18.0;52831430
2023-02-04;0;0;0;-20.0;52831430
2023-02-04;14;16;55;14.0;52831444
2023-02-04;85;93;288;71.0;52831529
2023-02-04;13;15;36;-72.0;52831542
2023-02-04;7;7;6;-6.0;52831549
2023-02-04;10;17;44;3.0;52831559
2023-02-04;1;0;1;-9.0;52831560
2023-02-04;3;10;2;2.0;52831563
2023-02-04;8;6;46;5.0;52831571
2023-02-04;13;7;37;5.0;52831584
2023-02-04;1;0;4;-12.0;52831585
2023-02-04;4;1;10;3.0;52831589
2023-02-04;3;4;15;-1.0;52831592
2023-02-04;7;7;18;4.0;52831599
2023-02-04;1;3;14;-6.0;52831600
2023-02-05;1;4;2;0.0;52831601
2023-02-05;0;0;1;-1.0;52831601
2023-02-05;3;3;12;3.0;52831604
2023-02-05;0;0;0;-3.0;52831604
2023-02-05;3;1;6;3.0;52831607
2023-02-05;0;0;0;-3.0;52831607
2023-02-05;0;0;0;0.0;52831607
2023-02-05;0;1;1;0.0;52831607
2023-02-05;1;4;6;1.0;52831608
2023-02-05;14;22;35;13.0;52831622
2023-02-05;0;0;0;-14.0;52831622
2023-02-05;2;5;3;2.0;52831624
2023-02-05;0;1;0;-2.0;52831624
2023-02-05;4;3;4;4.0;52831628
2023-02-05;0;0;0;-4.0;52831628
2023-02-06;2;1;0;2.0;52831630
2023-02-06;3;6;11;1.0;52831633
2023-02-06;6;9;30;3.0;52831639
2023-02-06;133;138;391;127.0;52831772
2023-02-06;2;1;11;-131.0;52831774
2023-02-06;7;15;54;5.0;52831781
2023-02-06;4;4;2;-3.0;52831785
2023-02-06;31;38;71;27.0;52831816
2023-02-06;3;3;18;-28.0;52831819
2023-02-06;12;10;42;9.0;52831831
2023-02-06;31;20;62;19.0;52831862
2023-02-06;7;12;37;-24.0;52831869
2023-02-06;18;12;39;11.0;52831887
2023-02-06;5;4;12;-13.0;52831892
2023-02-06;2;3;2;-3.0;52831894
2023-02-07;133;157;574;131.0;52832027
2023-02-07;7;8;29;-126.0;52832034
2023-02-07;4;8;35;-3.0;52832038
2023-02-07;5;19;73;1.0;52832043
2023-02-07;3;6;24;-2.0;52832046
2023-02-07;19;18;73;16.0;52832065
2023-02-07;2;3;6;-17.0;52832067
2023-02-07;7;7;29;5.0;52832074
2023-02-07;0;0;0;-7.0;52832074
2023-02-07;15;13;74;15.0;52832089
2023-02-07;3;2;3;-12.0;52832092
2023-02-07;3;5;28;0.0;52832095
2023-02-07;21;25;106;18.0;52832116
2023-02-07;21;17;28;0.0;52832137
2023-02-07;23;26;66;2.0;52832160
2023-02-08;2;0;14;-21.0;52832162
2023-02-08;13;7;48;11.0;52832175
2023-02-08;20;13;57;7.0;52832195
2023-02-08;12;20;63;-8.0;52832207
2023-02-08;126;121;424;114.0;52832333
2023-02-08;1;0;11;-125.0;52832334
2023-02-08;14;13;30;13.0;52832348
2023-02-08;2;0;0;-12.0;52832350
2023-02-08;10;22;82;8.0;52832360
2023-02-08;2;3;18;-8.0;52832362
2023-02-08;6;2;20;4.0;52832368
2023-02-08;8;8;29;2.0;52832376
2023-02-08;17;12;48;9.0;52832393
2023-02-08;8;9;2;-9.0;52832401
2023-02-08;11;12;2;3.0;52832412
2023-02-09;29;25;59;18.0;52832441
2023-02-09;7;4;40;-22.0;52832448
2023-02-09;4;5;4;-3.0;52832452
2023-02-09;32;29;63;28.0;52832484
2023-02-09;9;16;61;-23.0;52832493
2023-02-09;13;17;65;4.0;52832506
2023-02-09;4;6;18;-9.0;52832510
2023-02-09;3;2;22;-1.0;52832513
2023-02-09;150;148;485;147.0;52832663
2023-02-09;1;0;0;-149.0;52832664
2023-02-09;13;13;38;12.0;52832677
2023-02-09;6;1;18;-7.0;52832683
2023-02-09;6;2;1;0.0;52832689
2023-02-09;8;10;31;2.0;52832697
2023-02-09;15;18;65;7.0;52832712
2023-02-10;0;0;0;-15.0;52832712
2023-02-10;19;28;71;19.0;52832731
2023-02-10;10;3;28;-9.0;52832741
2023-02-10;4;10;6;-6.0;52832745
2023-02-10;4;3;13;0.0;52832749
2023-02-10;6;11;30;2.0;52832755
2023-02-10;24;22;59;18.0;52832779
2023-02-10;3;1;26;-21.0;52832782
2023-02-10;2;4;2;-1.0;52832784
2023-02-10;37;42;81;35.0;52832821
2023-02-10;10;7;28;-27.0;52832831
2023-02-10;14;15;50;4.0;52832845
2023-02-10;31;22;58;17.0;52832876
2023-02-10;195;196;530;164.0;52833071
2023-02-10;31;28;78;-164.0;52833102
2023-02-11;0;0;0;-31.0;52833102
2023-02-11;1;1;4;1.0;52833103
2023-02-11;1;1;4;0.0;52833104
2023-02-11;9;19;44;8.0;52833113
2023-02-11;4;6;2;-5.0;52833117
2023-02-11;11;14;40;7.0;52833128
2023-02-11;0;2;8;-11.0;52833128
2023-02-11;3;5;3;3.0;52833131
2023-02-11;4;2;8;1.0;52833135
2023-02-11;12;7;23;8.0;52833147
2023-02-11;8;11;34;-4.0;52833155
2023-02-11;13;5;29;5.0;52833168
2023-02-11;73;80;223;60.0;52833241
2023-02-11;2;1;4;-71.0;52833243
2023-02-11;5;6;20;3.0;52833248
2023-02-12;4;6;0;-1.0;52833252
2023-02-12;1;4;3;-3.0;52833253
2023-02-12;19;27;24;18.0;52833272
2023-02-12;0;0;1;-19.0;52833272
2023-02-12;1;1;2;1.0;52833273
2023-02-12;0;1;1;-1.0;52833273
2023-02-12;4;4;5;4.0;52833277
2023-02-12;0;0;0;-4.0;52833277
2023-02-12;2;2;1;2.0;52833279
2023-02-12;0;1;1;-2.0;52833279
2023-02-12;0;0;1;0.0;52833279
2023-02-12;0;0;3;0.0;52833279
2023-02-12;1;3;0;1.0;52833280
2023-02-12;3;2;5;2.0;52833283
2023-02-12;3;3;1;0.0;52833286
2023-02-13;1;1;10;-2.0;52833287
2023-02-13;2;4;14;1.0;52833289
2023-02-13;13;12;43;11.0;52833302
2023-02-13;4;1;12;-9.0;52833306
2023-02-13;15;10;33;11.0;52833321
2023-02-13;18;22;51;3.0;52833339
2023-02-13;8;13;30;-10.0;52833347
2023-02-13;5;3;11;-3.0;52833352
2023-02-13;21;32;56;16.0;52833373
2023-02-13;1;2;11;-20.0;52833374
2023-02-13;2;0;0;1.0;52833376
2023-02-13;0;3;1;-2.0;52833376
2023-02-13;13;14;35;13.0;52833389
2023-02-13;2;1;4;-11.0;52833391
2023-02-13;105;118;311;103.0;52833496
2023-02-14;35;20;55;-70.0;52833531
2023-02-14;3;6;18;-32.0;52833534
2023-02-14;7;8;24;4.0;52833541
2023-02-14;6;3;29;-1.0;52833547
2023-02-14;14;12;63;8.0;52833561
2023-02-14;10;8;33;-4.0;52833571
2023-02-14;2;0;0;-8.0;52833573
2023-02-14;132;125;446;130.0;52833705
2023-02-14;23;30;57;-109.0;52833728
2023-02-14;3;4;5;-20.0;52833731
2023-02-14;1;4;15;-2.0;52833732
2023-02-14;3;3;1;2.0;52833735
2023-02-14;1;4;16;-2.0;52833736
2023-02-14;12;10;67;11.0;52833748
2023-02-14;12;13;63;0.0;52833760
2023-02-15;4;3;15;-8.0;52833764
2023-02-15;18;19;63;14.0;52833782
2023-02-15;11;8;3;-7.0;52833793
2023-02-15;1;1;0;-10.0;52833794
2023-02-15;7;8;6;6.0;52833801
2023-02-15;109;119;389;102.0;52833910
2023-02-15;21;22;58;-88.0;52833931
2023-02-15;2;0;17;-19.0;52833933
2023-02-15;14;14;59;12.0;52833947
2023-02-15;4;7;53;-10.0;52833951
2023-02-15;2;1;10;-2.0;52833953
2023-02-15;10;14;27;8.0;52833963
2023-02-15;11;11;38;1.0;52833974
2023-02-15;1;3;14;-10.0;52833975
2023-02-15;3;8;26;2.0;52833978
2023-02-16;4;3;24;1.0;52833982
2023-02-16;0;0;0;-4.0;52833982
2023-02-16;8;8;24;8.0;52833990
2023-02-16;20;22;52;12.0;52834010
2023-02-16;15;22;57;-5.0;52834025
2023-02-16;2;3;2;-13.0;52834027
2023-02-16;113;116;432;111.0;52834140
2023-02-16;10;8;53;-103.0;52834150
2023-02-16;19;21;69;9.0;52834169
2023-02-16;2;1;20;-17.0;52834171
2023-02-16;16;10;54;14.0;52834187
2023-02-16;9;10;42;-7.0;52834196
2023-02-16;3;3;3;-6.0;52834199
2023-02-16;1;2;14;-2.0;52834200
2023-02-16;4;3;18;3.0;52834204
2023-02-17;34;37;74;30.0;52834238
2023-02-17;13;9;48;-21.0;52834251
2023-02-17;8;6;14;-5.0;52834259
2023-02-17;24;11;41;16.0;52834283
2023-02-17;5;2;4;-19.0;52834288
2023-02-17;1;3;24;-4.0;52834289
2023-02-17;0;1;0;-1.0;52834289
2023-02-17;11;24;67;11.0;52834300
2023-02-17;159;162;485;148.0;52834459
2023-02-17;28;28;82;-131.0;52834487
2023-02-17;19;22;60;-9.0;52834506
2023-02-17;4;7;23;-15.0;52834510
2023-02-17;5;3;33;1.0;52834515
2023-02-17;3;5;7;-2.0;52834518
2023-02-17;4;4;8;1.0;52834522
2023-02-18;0;0;0;-4.0;52834522
2023-02-18;12;5;32;12.0;52834534
2023-02-18;77;73;205;65.0;52834611
2023-02-18;0;4;10;-77.0;52834611
2023-02-18;2;1;2;2.0;52834613
2023-02-18;12;10;24;10.0;52834625
2023-02-18;4;5;23;-8.0;52834629
2023-02-18;4;4;2;0.0;52834633
2023-02-18;10;11;39;6.0;52834643
2023-02-18;1;0;4;-9.0;52834644
2023-02-18;13;15;34;12.0;52834657
2023-02-18;12;13;25;-1.0;52834669
2023-02-18;4;2;2;-8.0;52834673
2023-02-18;2;2;5;-2.0;52834675
2023-02-18;1;1;3;-1.0;52834676
2023-02-19;0;0;0;-1.0;52834676
2023-02-19;0;4;1;0.0;52834676
2023-02-19;2;2;4;2.0;52834678
2023-02-19;0;0;0;-2.0;52834678
2023-02-19;3;4;4;3.0;52834681
2023-02-19;0;0;0;-3.0;52834681
2023-02-19;6;2;7;6.0;52834687
2023-02-19;0;1;1;-6.0;52834687
2023-02-19;0;0;0;0.0;52834687
2023-02-19;3;1;0;3.0;52834690
2023-02-19;0;1;0;-3.0;52834690
2023-02-19;1;0;4;1.0;52834691
2023-02-19;0;0;0;-1.0;52834691
2023-02-19;0;1;0;0.0;52834691
2023-02-19;15;16;21;15.0;52834706
2023-02-20;1;3;0;-14.0;52834707
2023-02-20;0;0;0;-1.0;52834707
2023-02-20;14;12;29;14.0;52834721
2023-02-20;28;21;40;14.0;52834749
2023-02-20;5;3;11;-23.0;52834754
2023-02-20;2;4;3;-3.0;52834756
2023-02-20;2;3;11;0.0;52834758
2023-02-20;111;115;277;109.0;52834869
2023-02-20;5;2;9;-106.0;52834874
2023-02-20;8;12;27;3.0;52834882
2023-02-20;19;12;47;11.0;52834901
2023-02-20;12;24;31;-7.0;52834913
2023-02-20;10;12;49;-2.0;52834923
2023-02-20;2;1;10;-8.0;52834925
2023-02-20;3;6;10;1.0;52834928
2023-02-21;3;5;18;0.0;52834931
2023-02-21;0;1;0;-3.0;52834931
2023-02-21;1;0;4;1.0;52834932
2023-02-21;11;11;71;10.0;52834943
2023-02-21;105;113;366;94.0;52835048
2023-02-21;13;15;52;-92.0;52835061
2023-02-21;13;7;42;0.0;52835074
2023-02-21;2;3;13;-11.0;52835076
2023-02-21;2;2;9;0.0;52835078
2023-02-21;25;18;52;23.0;52835103
2023-02-21;4;8;13;-21.0;52835107
2023-02-21;8;10;16;4.0;52835115
2023-02-21;15;20;43;7.0;52835130
2023-02-21;2;3;4;-13.0;52835132
2023-02-21;6;10;29;4.0;52835138
2023-02-22;5;1;13;-1.0;52835143
2023-02-22;1;0;5;-4.0;52835144
2023-02-22;3;6;5;2.0;52835147
2023-02-22;2;3;2;-1.0;52835149
2023-02-22;94;117;273;92.0;52835243
2023-02-22;19;18;43;-75.0;52835262
2023-02-22;12;24;51;-7.0;52835274
2023-02-22;6;4;6;-6.0;52835280
2023-02-22;0;0;0;-6.0;52835280
2023-02-22;2;2;11;2.0;52835282
2023-02-22;4;10;31;2.0;52835286
2023-02-22;15;12;21;11.0;52835301
2023-02-22;16;15;28;1.0;52835317
2023-02-22;6;16;32;-10.0;52835323
2023-02-22;3;6;25;-3.0;52835326
2023-02-23;1;3;20;-2.0;52835327
2023-02-23;2;3;17;1.0;52835329
2023-02-23;5;1;10;3.0;52835334
2023-02-23;16;20;63;11.0;52835350
2023-02-23;2;4;14;-14.0;52835352
2023-02-23;13;16;32;11.0;52835365
2023-02-23;0;1;2;-13.0;52835365
2023-02-23;9;15;52;9.0;52835374
2023-02-23;87;98;353;78.0;52835461
2023-02-23;3;3;19;-84.0;52835464
2023-02-23;0;0;0;-3.0;52835464
2023-02-23;13;8;41;13.0;52835477
2023-02-23;9;6;36;-4.0;52835486
2023-02-23;13;16;45;4.0;52835499
2023-02-23;1;2;2;-12.0;52835500
2023-02-24;1;2;8;0.0;52835501
2023-02-24;4;2;12;3.0;52835505
2023-02-24;3;6;16;-1.0;52835508
2023-02-24;4;5;14;1.0;52835512
2023-02-24;12;18;89;8.0;52835524
2023-02-24;25;30;55;13.0;52835549
2023-02-24;13;18;42;-12.0;52835562
2023-02-24;0;0;0;-13.0;52835562
2023-02-24;5;7;1;5.0;52835567
2023-02-24;16;12;34;11.0;52835583
2023-02-24;128;153;389;112.0;52835711
2023-02-24;2;4;11;-126.0;52835713
2023-02-24;6;11;5;4.0;52835719
2023-02-24;22;21;57;16.0;52835741
2023-02-24;15;17;45;-7.0;52835756
2023-02-25;0;2;3;-15.0;52835756
2023-02-25;7;12;30;7.0;52835763
2023-02-25;8;10;21;1.0;52835771
2023-02-25;2;4;0;-6.0;52835773
2023-02-25;0;0;0;-2.0;52835773
2023-02-25;4;3;2;4.0;52835777
2023-02-25;0;1;4;-4.0;52835777
2023-02-25;56;70;172;56.0;52835833
2023-02-25;12;10;28;-44.0;52835845
2023-02-25;8;11;29;-4.0;52835853
2023-02-25;6;3;18;-2.0;52835859
2023-02-25;0;0;1;-6.0;52835859
2023-02-25;0;1;9;0.0;52835859
2023-02-25;9;12;22;9.0;52835868
2023-02-25;0;1;5;-9.0;52835868
2023-02-26;1;2;3;1.0;52835869
2023-02-26;2;1;1;1.0;52835871
2023-02-26;9;15;15;7.0;52835880
2023-02-26;1;3;2;-8.0;52835881
2023-02-26;0;0;1;-1.0;52835881
2023-02-26;0;0;0;0.0;52835881
2023-02-26;1;1;1;1.0;52835882
2023-02-26;0;0;0;-1.0;52835882
2023-02-26;0;0;0;0.0;52835882
2023-02-26;0;4;3;0.0;52835882
2023-02-26;0;0;0;0.0;52835882
2023-02-26;1;0;0;1.0;52835883
2023-02-26;0;0;2;-1.0;52835883
2023-02-26;0;0;0;0.0;52835883
2023-02-26;3;4;2;3.0;52835886
2023-02-27;8;12;41;5.0;52835894
2023-02-27;2;1;7;-6.0;52835896
2023-02-27;2;3;1;0.0;52835898
2023-02-27;10;19;31;8.0;52835908
2023-02-27;18;16;51;8.0;52835926
2023-02-27;100;106;267;82.0;52836026
2023-02-27;3;2;11;-97.0;52836029
2023-02-27;5;17;32;2.0;52836034
2023-02-27;2;1;7;-3.0;52836036
2023-02-27;1;3;2;-1.0;52836037
2023-02-27;8;7;19;7.0;52836045
2023-02-27;2;3;15;-6.0;52836047
2023-02-27;36;21;47;34.0;52836083
2023-02-27;3;1;3;-33.0;52836086
2023-02-27;0;0;0;-3.0;52836086
2023-02-28;5;17;38;5.0;52836091
2023-02-28;6;2;12;1.0;52836097
2023-02-28;2;0;2;-4.0;52836099
2023-02-28;22;15;54;20.0;52836121
2023-02-28;1;4;3;-21.0;52836122
2023-02-28;1;3;13;0.0;52836123
2023-02-28;11;13;48;10.0;52836134
2023-02-28;4;4;13;-7.0;52836138
2023-02-28;13;8;37;9.0;52836151
2023-02-28;2;3;1;-11.0;52836153
2023-02-28;1;1;0;-1.0;52836154
2023-02-28;40;21;52;39.0;52836194
2023-02-28;117;104;324;77.0;52836311
2023-02-28;6;11;36;-111.0;52836317
2023-02-28;3;2;15;-3.0;52836320
2023-03-01;15;16;68;12.0;52836335
2023-03-01;3;7;3;-12.0;52836338
2023-03-01;21;20;65;18.0;52836359
2023-03-01;3;2;5;-18.0;52836362
2023-03-01;4;5;8;1.0;52836366
2023-03-01;1;5;13;-3.0;52836367
2023-03-01;0;1;0;-1.0;52836367
2023-03-01;10;16;47;10.0;52836377
2023-03-01;11;13;37;1.0;52836388
2023-03-01;3;1;8;-8.0;52836391
2023-03-01;10;14;48;7.0;52836401
2023-03-01;4;9;37;-6.0;52836405
2023-03-01;6;6;0;2.0;52836411
2023-03-01;4;2;2;-2.0;52836415
2023-03-01;95;117;341;91.0;52836510
2023-03-02;17;10;27;-78.0;52836527
2023-03-02;4;1;11;-13.0;52836531
2023-03-02;4;6;19;0.0;52836535
2023-03-02;21;17;43;17.0;52836556
2023-03-02;3;4;1;-18.0;52836559
2023-03-02;23;18;58;20.0;52836582
2023-03-02;2;1;13;-21.0;52836584
2023-03-02;1;0;0;-1.0;52836585
2023-03-02;106;90;342;105.0;52836691
2023-03-02;9;11;41;-97.0;52836700
2023-03-02;2;5;6;-7.0;52836702
2023-03-02;2;0;10;0.0;52836704
2023-03-02;5;9;53;3.0;52836709
2023-03-02;1;1;13;-4.0;52836710
2023-03-02;12;7;47;11.0;52836722
2023-03-03;4;2;3;-8.0;52836726
2023-03-03;21;23;72;17.0;52836747
2023-03-03;1;1;2;-20.0;52836748
2023-03-03;19;18;41;18.0;52836767
2023-03-03;19;16;58;0.0;52836786
2023-03-03;4;5;17;-15.0;52836790
2023-03-03;15;10;46;11.0;52836805
2023-03-03;151;150;405;136.0;52836956
2023-03-03;2;7;12;-149.0;52836958
2023-03-03;22;30;59;20.0;52836980
2023-03-03;2;2;10;-20.0;52836982
2023-03-03;5;9;15;3.0;52836987
2023-03-03;35;25;67;30.0;52837022
2023-03-03;2;2;3;-33.0;52837024
2023-03-03;0;0;0;-2.0;52837024
2023-03-04;10;10;28;10.0;52837034
2023-03-04;2;2;5;-8.0;52837036
2023-03-04;2;1;0;0.0;52837038
2023-03-04;2;3;3;0.0;52837040
2023-03-04;56;60;153;54.0;52837096
2023-03-04;2;1;5;-54.0;52837098
2023-03-04;0;0;2;-2.0;52837098
2023-03-04;1;0;1;1.0;52837099
2023-03-04;5;10;14;4.0;52837104
2023-03-04;3;4;13;-2.0;52837107
2023-03-04;7;9;36;4.0;52837114
2023-03-04;2;5;6;-5.0;52837116
2023-03-04;8;6;20;6.0;52837124
2023-03-04;3;0;3;-5.0;52837127
2023-03-04;9;9;17;6.0;52837136
2023-03-05;0;0;0;-9.0;52837136
2023-03-05;3;1;1;3.0;52837139
2023-03-05;1;2;4;-2.0;52837140
2023-03-05;0;0;0;-1.0;52837140
2023-03-05;1;1;0;1.0;52837141
2023-03-05;0;0;0;-1.0;52837141
2023-03-05;1;1;2;1.0;52837142
2023-03-05;1;1;0;0.0;52837143
2023-03-05;0;0;0;-1.0;52837143
2023-03-05;1;0;3;1.0;52837144
2023-03-05;1;0;0;0.0;52837145
2023-03-05;11;9;12;10.0;52837156
2023-03-05;1;1;1;-10.0;52837157
2023-03-05;1;1;0;0.0;52837158
2023-03-05;0;1;1;-1.0;52837158
2023-03-06;2;1;8;2.0;52837160
2023-03-06;2;0;10;0.0;52837162
2023-03-06;14;11;35;12.0;52837176
2023-03-06;115;79;242;101.0;52837291
2023-03-06;0;2;2;-115.0;52837291
2023-03-06;7;9;23;7.0;52837298
2023-03-06;0;3;2;-7.0;52837298
2023-03-06;2;0;0;2.0;52837300
2023-03-06;24;16;44;22.0;52837324
2023-03-06;1;0;4;-23.0;52837325
2023-03-06;1;1;8;0.0;52837326
2023-03-06;3;3;3;2.0;52837329
2023-03-06;41;18;54;38.0;52837370
2023-03-06;11;5;24;-30.0;52837381
2023-03-06;7;10;25;-4.0;52837388
2023-03-07;1;0;6;-6.0;52837389
2023-03-07;0;3;1;-1.0;52837389
2023-03-07;9;5;23;9.0;52837398
2023-03-07;76;89;252;67.0;52837474
2023-03-07;18;31;44;-58.0;52837492
2023-03-07;0;0;0;-18.0;52837492
2023-03-07;8;9;37;8.0;52837500
2023-03-07;1;2;11;-7.0;52837501
2023-03-07;3;8;42;2.0;52837504
2023-03-07;3;1;10;0.0;52837507
2023-03-07;6;6;26;3.0;52837513
2023-03-07;21;18;33;15.0;52837534
2023-03-07;2;2;6;-19.0;52837536
2023-03-07;2;0;9;0.0;52837538
2023-03-07;2;4;4;0.0;52837540
2023-03-08;1;0;8;-1.0;52837541
2023-03-08;11;16;17;10.0;52837552
2023-03-08;7;12;43;-4.0;52837559
2023-03-08;62;102;188;55.0;52837621
2023-03-08;5;6;11;-57.0;52837626
2023-03-08;2;9;0;-3.0;52837628
2023-03-08;2;0;6;0.0;52837630
2023-03-08;1;3;2;-1.0;52837631
2023-03-08;2;5;27;1.0;52837633
2023-03-08;1;1;7;-1.0;52837634
2023-03-08;13;16;25;12.0;52837647
2023-03-08;11;24;31;-2.0;52837658
2023-03-08;1;0;0;-10.0;52837659
2023-03-08;4;9;0;3.0;52837663
2023-03-08;1;1;11;-3.0;52837664
2023-03-09;5;6;26;4.0;52837669
2023-03-09;19;19;34;14.0;52837688
2023-03-09;0;1;2;-19.0;52837688
2023-03-09;0;0;0;0.0;52837688
2023-03-09;9;11;36;9.0;52837697
2023-03-09;23;16;54;14.0;52837720
2023-03-09;75;82;263;52.0;52837795
2023-03-09;6;10;34;-69.0;52837801
2023-03-09;0;0;0;-6.0;52837801
2023-03-09;1;6;10;1.0;52837802
2023-03-09;4;6;28;3.0;52837806
2023-03-09;2;0;10;-2.0;52837808
2023-03-09;2;2;7;0.0;52837810
2023-03-09;1;1;8;-1.0;52837811
2023-03-09;3;4;14;2.0;52837814
2023-03-10;3;2;13;0.0;52837817
2023-03-10;32;21;73;29.0;52837849
2023-03-10;13;12;26;-19.0;52837862
2023-03-10;23;30;51;10.0;52837885
2023-03-10;13;13;37;-10.0;52837898
2023-03-10;128;140;354;115.0;52838026
2023-03-10;11;18;63;-117.0;52838037
2023-03-10;4;1;10;-7.0;52838041
2023-03-10;2;4;0;-2.0;52838043
2023-03-10;1;4;1;-1.0;52838044
2023-03-10;14;22;35;13.0;52838058
2023-03-10;4;4;6;-10.0;52838062
2023-03-10;3;3;25;-1.0;52838065
2023-03-10;0;0;0;-3.0;52838065
2023-03-10;5;6;14;5.0;52838070
2023-03-11;1;1;3;-4.0;52838071
2023-03-11;1;0;2;0.0;52838072
2023-03-11;2;2;3;1.0;52838074
2023-03-11;13;10;28;11.0;52838087
2023-03-11;5;8;11;-8.0;52838092
2023-03-11;5;5;18;0.0;52838097
2023-03-11;3;4;0;-2.0;52838100
2023-03-11;1;1;1;-2.0;52838101
2023-03-11;0;0;1;-1.0;52838101
2023-03-11;9;7;22;9.0;52838110
2023-03-11;5;8;13;-4.0;52838115
2023-03-11;60;59;141;55.0;52838175
2023-03-11;13;12;39;-47.0;52838188
2023-03-11;1;1;0;-12.0;52838189
2023-03-11;1;0;0;0.0;52838190
2023-03-12;0;0;0;-1.0;52838190
2023-03-12;1;1;0;1.0;52838191
2023-03-12;1;1;3;0.0;52838192
2023-03-12;5;8;18;4.0;52838197
2023-03-12;0;0;1;-5.0;52838197
2023-03-12;1;1;1;1.0;52838198
2023-03-12;0;0;0;-1.0;52838198
2023-03-12;0;2;2;0.0;52838198
2023-03-12;0;0;1;0.0;52838198
2023-03-12;0;0;0;0.0;52838198
2023-03-12;0;0;2;0.0;52838198
2023-03-12;1;1;2;1.0;52838199
2023-03-12;0;0;4;-1.0;52838199
2023-03-12;1;1;2;1.0;52838200
2023-03-12;0;1;0;-1.0;52838200
2023-03-13;2;5;4;2.0;52838202
2023-03-13;3;10;22;1.0;52838205
2023-03-13;0;3;0;-3.0;52838205
2023-03-13;13;16;36;13.0;52838218
2023-03-13;1;2;4;-12.0;52838219
2023-03-13;1;3;2;0.0;52838220
2023-03-13;51;85;171;50.0;52838271
2023-03-13;0;0;3;-51.0;52838271
2023-03-13;14;14;34;14.0;52838285
2023-03-13;1;6;20;-13.0;52838286
2023-03-13;0;0;0;-1.0;52838286
2023-03-13;9;11;19;9.0;52838295
2023-03-13;0;0;0;-9.0;52838295
2023-03-13;6;9;24;6.0;52838301
2023-03-13;1;6;3;-5.0;52838302
2023-03-14;9;7;32;8.0;52838311
2023-03-14;5;7;18;-4.0;52838316
2023-03-14;0;1;8;-5.0;52838316
2023-03-14;0;4;10;0.0;52838316
2023-03-14;9;7;21;9.0;52838325
2023-03-14;1;2;3;-8.0;52838326
2023-03-14;8;9;22;7.0;52838334
2023-03-14;13;10;51;5.0;52838347
2023-03-14;1;2;1;-12.0;52838348
2023-03-14;0;0;0;-1.0;52838348
2023-03-14;72;70;262;72.0;52838420
2023-03-14;1;1;1;-71.0;52838421
2023-03-14;3;1;9;2.0;52838424
2023-03-14;21;17;81;18.0;52838445
2023-03-14;1;2;5;-20.0;52838446
2023-03-15;12;9;37;11.0;52838458
2023-03-15;7;8;5;-5.0;52838465
2023-03-15;1;3;8;-6.0;52838466
2023-03-15;1;1;8;0.0;52838467
2023-03-15;6;10;13;5.0;52838473
2023-03-15;0;0;3;-6.0;52838473
2023-03-15;7;12;19;7.0;52838480
2023-03-15;0;1;0;-7.0;52838480
2023-03-15;7;12;20;7.0;52838487
2023-03-15;1;0;4;-6.0;52838488
2023-03-15;2;3;8;1.0;52838490
2023-03-15;10;14;44;8.0;52838500
2023-03-15;63;84;213;53.0;52838563
2023-03-15;1;2;0;-62.0;52838564
2023-03-15;8;9;44;7.0;52838572
2023-03-16;1;1;6;-7.0;52838573
2023-03-16;0;4;2;-1.0;52838573
2023-03-16;0;1;2;0.0;52838573
2023-03-16;15;8;44;15.0;52838588
2023-03-16;83;81;249;68.0;52838671
2023-03-16;2;2;8;-81.0;52838673
2023-03-16;7;4;25;5.0;52838680
2023-03-16;0;1;0;-7.0;52838680
2023-03-16;4;3;10;4.0;52838684
2023-03-16;6;4;27;2.0;52838690
2023-03-16;32;35;39;26.0;52838722
2023-03-16;3;3;8;-29.0;52838725
2023-03-16;9;8;39;6.0;52838734
2023-03-16;4;7;39;-5.0;52838738
2023-03-16;0;0;0;-4.0;52838738
2023-03-17;15;17;38;15.0;52838753
2023-03-17;2;4;1;-13.0;52838755
2023-03-17;1;4;12;-1.0;52838756
2023-03-17;4;2;10;3.0;52838760
2023-03-17;127;125;301;123.0;52838887
2023-03-17;3;3;7;-124.0;52838890
2023-03-17;2;0;0;-1.0;52838892
2023-03-17;26;23;55;24.0;52838918
2023-03-17;2;0;2;-24.0;52838920
2023-03-17;12;19;47;10.0;52838932
2023-03-17;5;3;1;-7.0;52838937
2023-03-17;2;1;6;-3.0;52838939
2023-03-17;9;14;47;7.0;52838948
2023-03-17;17;13;24;8.0;52838965
2023-03-17;27;22;51;10.0;52838992
2023-03-18;9;9;43;-18.0;52839001
2023-03-18;2;4;24;-7.0;52839003
2023-03-18;0;0;2;-2.0;52839003
2023-03-18;4;2;3;4.0;52839007
2023-03-18;11;4;33;7.0;52839018
2023-03-18;0;6;0;-11.0;52839018
2023-03-18;0;0;1;0.0;52839018
2023-03-18;0;0;1;0.0;52839018
2023-03-18;5;7;31;5.0;52839023
2023-03-18;1;0;0;-4.0;52839024
2023-03-18;42;48;198;41.0;52839066
2023-03-18;0;0;4;-42.0;52839066
2023-03-18;6;9;36;6.0;52839072
2023-03-18;2;3;2;-4.0;52839074
2023-03-18;2;4;18;0.0;52839076
2023-03-19;0;0;0;-2.0;52839076
2023-03-19;3;3;1;3.0;52839079
2023-03-19;2;2;0;-1.0;52839081
2023-03-19;2;1;5;0.0;52839083
2023-03-19;0;1;0;-2.0;52839083
2023-03-19;0;0;0;0.0;52839083
2023-03-19;4;1;0;4.0;52839087
2023-03-19;15;10;8;11.0;52839102
2023-03-19;3;0;2;-12.0;52839105
2023-03-19;0;1;0;-3.0;52839105
2023-03-19;0;1;0;0.0;52839105
2023-03-19;0;0;0;0.0;52839105
2023-03-19;0;0;0;0.0;52839105
2023-03-19;0;0;0;0.0;52839105
2023-03-19;1;0;0;1.0;52839106
2023-03-20;65;70;197;64.0;52839171
2023-03-20;0;0;2;-65.0;52839171
2023-03-20;6;7;23;6.0;52839177
2023-03-20;6;3;18;0.0;52839183
2023-03-20;2;2;3;-4.0;52839185
2023-03-20;0;0;10;-2.0;52839185
2023-03-20;3;0;7;3.0;52839188
2023-03-20;7;12;29;4.0;52839195
2023-03-20;1;0;0;-6.0;52839196
2023-03-20;2;4;1;1.0;52839198
2023-03-20;5;13;28;3.0;52839203
2023-03-20;1;3;5;-4.0;52839204
2023-03-20;12;9;37;11.0;52839216
2023-03-20;17;17;32;5.0;52839233
2023-03-20;3;0;2;-14.0;52839236
2023-03-21;10;6;27;7.0;52839246
2023-03-21;2;2;4;-8.0;52839248
2023-03-21;3;3;8;1.0;52839251
2023-03-21;0;3;18;-3.0;52839251
2023-03-21;5;7;52;5.0;52839256
2023-03-21;24;14;54;19.0;52839280
2023-03-21;1;0;8;-23.0;52839281
2023-03-21;2;1;11;1.0;52839283
2023-03-21;10;7;49;8.0;52839293
2023-03-21;10;5;35;0.0;52839303
2023-03-21;1;3;2;-9.0;52839304
2023-03-21;81;63;300;80.0;52839385
2023-03-21;9;11;32;-72.0;52839394
2023-03-21;2;0;0;-7.0;52839396
2023-03-21;2;1;0;0.0;52839398
2023-03-22;19;16;40;17.0;52839417
2023-03-22;0;0;0;-19.0;52839417
2023-03-22;2;1;5;2.0;52839419
2023-03-22;4;1;0;2.0;52839423
2023-03-22;8;10;20;4.0;52839431
2023-03-22;0;1;9;-8.0;52839431
2023-03-22;2;2;6;2.0;52839433
2023-03-22;4;8;20;2.0;52839437
2023-03-22;1;4;2;-3.0;52839438
2023-03-22;5;7;2;4.0;52839443
2023-03-22;74;76;211;69.0;52839517
2023-03-22;8;7;24;-66.0;52839525
2023-03-22;12;11;50;4.0;52839537
2023-03-22;7;6;24;-5.0;52839544
2023-03-22;2;2;9;-5.0;52839546
2023-03-23;5;7;38;3.0;52839551
2023-03-23;3;2;14;-2.0;52839554
2023-03-23;64;63;238;61.0;52839618
2023-03-23;2;1;9;-62.0;52839620
2023-03-23;10;14;42;8.0;52839630
2023-03-23;2;3;11;-8.0;52839632
2023-03-23;19;9;46;17.0;52839651
2023-03-23;8;10;21;-11.0;52839659
2023-03-23;6;4;22;-2.0;52839665
2023-03-23;2;1;6;-4.0;52839667
2023-03-23;0;0;3;-2.0;52839667
2023-03-23;4;8;19;4.0;52839671
2023-03-23;1;0;6;-3.0;52839672
2023-03-23;0;0;0;-1.0;52839672
2023-03-23;2;4;1;2.0;52839674
2023-03-24;13;20;53;11.0;52839687
2023-03-24;2;5;12;-11.0;52839689
2023-03-24;18;18;54;16.0;52839707
2023-03-24;107;130;373;89.0;52839814
2023-03-24;3;1;4;-104.0;52839817
2023-03-24;2;2;7;-1.0;52839819
2023-03-24;2;4;1;0.0;52839821
2023-03-24;1;2;2;-1.0;52839822
2023-03-24;24;23;78;23.0;52839846
2023-03-24;1;1;3;-23.0;52839847
2023-03-24;0;0;0;-1.0;52839847
2023-03-24;17;22;68;17.0;52839864
2023-03-24;1;3;7;-16.0;52839865
2023-03-24;13;16;53;12.0;52839878
2023-03-24;10;13;31;-3.0;52839888
2023-03-25;13;10;31;3.0;52839901
2023-03-25;2;2;3;-11.0;52839903
2023-03-25;10;9;15;8.0;52839913
2023-03-25;1;1;0;-9.0;52839914
2023-03-25;8;12;29;7.0;52839922
2023-03-25;0;0;3;-8.0;52839922
2023-03-25;8;11;11;8.0;52839930
2023-03-25;63;70;131;55.0;52839993
2023-03-25;3;2;3;-60.0;52839996
2023-03-25;0;2;0;-3.0;52839996
2023-03-25;0;0;1;0.0;52839996
2023-03-25;9;15;26;9.0;52840005
2023-03-25;1;1;0;-8.0;52840006
2023-03-25;1;1;3;0.0;52840007
2023-03-25;7;4;6;6.0;52840014
2023-03-26;1;0;0;-6.0;52840015
2023-03-26;0;0;0;-1.0;52840015
2023-03-26;0;3;2;0.0;52840015
2023-03-26;4;7;11;4.0;52840019
2023-03-26;1;0;1;-3.0;52840020
2023-03-26;0;1;1;-1.0;52840020
2023-03-26;0;1;0;0.0;52840020
2023-03-26;1;1;0;1.0;52840021
2023-03-26;0;0;1;-1.0;52840021
2023-03-26;0;0;0;0.0;52840021
2023-03-26;1;0;2;1.0;52840022
2023-03-26;0;0;2;-1.0;52840022
2023-03-26;0;1;2;0.0;52840022
2023-03-26;0;0;0;0.0;52840022
2023-03-26;0;0;0;0.0;52840022
2023-03-27;0;0;0;0.0;52840022
2023-03-27;17;19;29;17.0;52840039
2023-03-27;0;0;7;-17.0;52840039
2023-03-27;1;2;10;1.0;52840040
2023-03-27;2;2;8;1.0;52840042
2023-03-27;0;1;0;-2.0;52840042
2023-03-27;5;14;7;5.0;52840047
2023-03-27;3;10;40;-2.0;52840050
2023-03-27;4;7;20;1.0;52840054
2023-03-27;52;23;54;48.0;52840106
2023-03-27;18;17;21;-34.0;52840124
2023-03-27;106;99;199;88.0;52840230
2023-03-27;4;3;1;-102.0;52840234
2023-03-27;0;1;1;-4.0;52840234
2023-03-27;0;0;1;0.0;52840234
2023-03-28;13;8;36;13.0;52840247
2023-03-28;3;4;27;-10.0;52840250
2023-03-28;10;14;27;7.0;52840260
2023-03-28;1;0;0;-9.0;52840261
2023-03-28;10;13;26;9.0;52840271
2023-03-28;2;2;0;-8.0;52840273
2023-03-28;2;2;8;0.0;52840275
2023-03-28;68;71;241;66.0;52840343
2023-03-28;11;12;41;-57.0;52840354
2023-03-28;1;1;8;-10.0;52840355
2023-03-28;5;2;5;4.0;52840360
2023-03-28;2;1;4;-3.0;52840362
2023-03-28;0;0;11;-2.0;52840362
2023-03-28;7;9;47;7.0;52840369
2023-03-28;1;3;1;-6.0;52840370
2023-03-29;25;8;33;24.0;52840395
2023-03-29;12;9;38;-13.0;52840407
2023-03-29;5;7;17;-7.0;52840412
2023-03-29;1;1;4;-4.0;52840413
2023-03-29;2;5;17;1.0;52840415
2023-03-29;15;11;25;13.0;52840430
2023-03-29;3;2;6;-12.0;52840433
2023-03-29;1;1;4;-2.0;52840434
2023-03-29;0;1;1;-1.0;52840434
2023-03-29;1;3;11;1.0;52840435
2023-03-29;1;1;4;0.0;52840436
2023-03-29;4;5;4;3.0;52840440
2023-03-29;84;67;193;80.0;52840524
2023-03-29;1;4;4;-83.0;52840525
2023-03-29;13;9;25;12.0;52840538
2023-03-30;0;2;7;-13.0;52840538
2023-03-30;15;16;34;15.0;52840553
2023-03-30;12;13;37;-3.0;52840565
2023-03-30;5;9;22;-7.0;52840570
2023-03-30;0;1;0;-5.0;52840570
2023-03-30;74;71;219;74.0;52840644
2023-03-30;2;1;2;-72.0;52840646
2023-03-30;0;2;0;-2.0;52840646
2023-03-30;0;0;2;0.0;52840646
2023-03-30;4;3;43;4.0;52840650
2023-03-30;16;5;23;12.0;52840666
2023-03-30;1;3;7;-15.0;52840667
2023-03-30;1;4;9;0.0;52840668
2023-03-30;3;1;5;2.0;52840671
2023-03-30;15;11;28;12.0;52840686
2023-03-31;2;0;5;-13.0;52840688
2023-03-31;5;10;16;3.0;52840693
2023-03-31;17;26;36;12.0;52840710
2023-03-31;2;4;0;-15.0;52840712
2023-03-31;3;3;6;1.0;52840715
2023-03-31;6;2;13;3.0;52840721
2023-03-31;9;18;62;3.0;52840730
2023-03-31;11;6;39;2.0;52840741
2023-03-31;0;0;1;-11.0;52840741
2023-03-31;14;20;18;14.0;52840755
2023-03-31;2;4;9;-12.0;52840757
2023-03-31;1;2;9;-1.0;52840758
2023-03-31;3;2;5;2.0;52840761
2023-03-31;93;127;250;90.0;52840854
2023-03-31;18;30;31;-75.0;52840872
2023-04-01;17;16;37;-1.0;52840889
2023-04-01;1;0;1;-16.0;52840890
2023-04-01;52;56;181;51.0;52840942
2023-04-01;0;1;0;-52.0;52840942
2023-04-01;6;11;39;6.0;52840948
2023-04-01;0;0;2;-6.0;52840948
2023-04-01;3;1;0;3.0;52840951
2023-04-01;3;5;15;0.0;52840954
2023-04-01;2;1;3;-1.0;52840956
2023-04-01;1;4;1;-1.0;52840957
2023-04-01;0;0;1;-1.0;52840957
2023-04-01;0;0;3;0.0;52840957
2023-04-01;3;1;16;3.0;52840960
2023-04-01;9;10;37;6.0;52840969
2023-04-01;7;6;26;-2.0;52840976
2023-04-02;0;1;2;-7.0;52840976
2023-04-02;0;0;4;0.0;52840976
2023-04-02;0;1;0;0.0;52840976
2023-04-02;0;1;0;0.0;52840976
2023-04-02;1;0;1;1.0;52840977
2023-04-02;0;0;0;-1.0;52840977
2023-04-02;1;0;3;1.0;52840978
2023-04-02;4;7;20;3.0;52840982
2023-04-02;2;2;3;-2.0;52840984
2023-04-02;0;0;0;-2.0;52840984
2023-04-02;0;0;0;0.0;52840984
2023-04-02;0;0;0;0.0;52840984
2023-04-02;0;0;0;0.0;52840984
2023-04-02;0;2;7;0.0;52840984
2023-04-02;0;0;0;0.0;52840984
2023-04-03;4;9;29;4.0;52840988
2023-04-03;0;0;2;-4.0;52840988
2023-04-03;1;4;0;1.0;52840989
2023-04-03;5;3;6;4.0;52840994
2023-04-03;2;3;6;-3.0;52840996
2023-04-03;6;9;39;4.0;52841002
2023-04-03;0;1;0;-6.0;52841002
2023-04-03;9;15;39;9.0;52841011
2023-04-03;47;19;48;38.0;52841058
2023-04-03;9;3;36;-38.0;52841067
2023-04-03;0;1;0;-9.0;52841067
2023-04-03;94;74;233;94.0;52841161
2023-04-03;2;0;5;-92.0;52841163
2023-04-03;6;7;18;4.0;52841169
2023-04-03;3;0;5;-3.0;52841172
2023-04-04;3;1;4;0.0;52841175
2023-04-04;0;2;8;-3.0;52841175
2023-04-04;2;3;8;2.0;52841177
2023-04-04;11;15;39;9.0;52841188
2023-04-04;1;0;1;-10.0;52841189
2023-04-04;1;1;5;0.0;52841190
2023-04-04;2;6;18;1.0;52841192
2023-04-04;8;20;31;6.0;52841200
2023-04-04;4;6;27;-4.0;52841204
2023-04-04;0;1;0;-4.0;52841204
2023-04-04;1;2;6;1.0;52841205
2023-04-04;9;8;22;8.0;52841214
2023-04-04;2;6;40;-7.0;52841216
2023-04-04;44;71;209;42.0;52841260
2023-04-04;0;0;0;-44.0;52841260
2023-04-05;53;57;159;53.0;52841313
2023-04-05;1;1;0;-52.0;52841314
2023-04-05;2;1;5;1.0;52841316
2023-04-05;1;0;3;-1.0;52841317
2023-04-05;4;10;14;3.0;52841321
2023-04-05;1;1;2;-3.0;52841322
2023-04-05;0;4;6;-1.0;52841322
2023-04-05;0;0;0;0.0;52841322
2023-04-05;11;13;30;11.0;52841333
2023-04-05;1;0;2;-10.0;52841334
2023-04-05;19;12;37;18.0;52841353
2023-04-05;1;3;6;-18.0;52841354
2023-04-05;3;5;24;2.0;52841357
2023-04-05;5;3;15;2.0;52841362
2023-04-05;4;4;15;-1.0;52841366
2023-04-06;73;53;179;69.0;52841439
2023-04-06;8;4;18;-65.0;52841447
2023-04-06;2;1;1;-6.0;52841449
2023-04-06;6;5;34;4.0;52841455
2023-04-06;23;8;37;17.0;52841478
2023-04-06;1;1;0;-22.0;52841479
2023-04-06;1;3;8;0.0;52841480
2023-04-06;0;0;3;-1.0;52841480
2023-04-06;0;1;1;0.0;52841480
2023-04-06;7;4;15;7.0;52841487
2023-04-06;8;9;26;1.0;52841495
2023-04-06;0;0;0;-8.0;52841495
2023-04-06;1;0;4;1.0;52841496
2023-04-06;5;3;6;4.0;52841501
2023-04-06;11;14;26;6.0;52841512
2023-04-07;12;22;42;1.0;52841524
2023-04-07;6;1;0;-6.0;52841530
2023-04-07;2;0;8;-4.0;52841532
2023-04-07;0;0;0;-2.0;52841532
2023-04-07;6;12;15;6.0;52841538
2023-04-07;14;19;32;8.0;52841552
2023-04-07;77;101;218;63.0;52841629
2023-04-07;11;16;24;-66.0;52841640
2023-04-07;4;5;5;-7.0;52841644
2023-04-07;0;2;11;-4.0;52841644
2023-04-07;1;2;6;1.0;52841645
2023-04-07;9;9;20;8.0;52841654
2023-04-07;1;2;3;-8.0;52841655
2023-04-07;8;11;47;7.0;52841663
2023-04-07;3;0;5;-5.0;52841666
2023-04-08;5;9;19;2.0;52841671
2023-04-08;0;1;1;-5.0;52841671
2023-04-08;8;4;19;8.0;52841679
2023-04-08;0;2;0;-8.0;52841679
2023-04-08;2;7;32;2.0;52841681
2023-04-08;1;2;1;-1.0;52841682
2023-04-08;2;0;0;1.0;52841684
2023-04-08;1;1;15;-1.0;52841685
2023-04-08;2;2;10;1.0;52841687
2023-04-08;2;1;1;0.0;52841689
2023-04-08;2;1;1;0.0;52841691
2023-04-08;27;34;103;25.0;52841718
2023-04-08;0;2;0;-27.0;52841718
2023-04-08;1;0;1;1.0;52841719
2023-04-08;1;2;3;0.0;52841720
2023-04-09;0;0;2;-1.0;52841720
2023-04-09;0;0;0;0.0;52841720
2023-04-09;0;0;0;0.0;52841720
2023-04-09;1;0;1;1.0;52841721
2023-04-09;0;0;0;-1.0;52841721
2023-04-09;0;0;0;0.0;52841721
2023-04-09;2;0;3;2.0;52841723
2023-04-09;0;0;0;-2.0;52841723
2023-04-09;0;1;2;0.0;52841723
2023-04-09;5;2;9;5.0;52841728
2023-04-09;0;0;0;-5.0;52841728
2023-04-09;2;0;0;2.0;52841730
2023-04-09;0;0;0;-2.0;52841730
2023-04-09;0;0;0;0.0;52841730
2023-04-09;0;1;1;0.0;52841730
2023-04-10;0;1;0;0.0;52841730
2023-04-10;1;3;8;1.0;52841731
2023-04-10;0;0;0;-1.0;52841731
2023-04-10;0;0;0;0.0;52841731
2023-04-10;0;2;5;0.0;52841731
2023-04-10;0;1;2;0.0;52841731
2023-04-10;1;2;4;1.0;52841732
2023-04-10;0;0;0;-1.0;52841732
2023-04-10;1;2;1;1.0;52841733
2023-04-10;5;13;24;4.0;52841738
2023-04-10;0;0;0;-5.0;52841738
2023-04-10;0;0;0;0.0;52841738
2023-04-10;0;0;0;0.0;52841738
2023-04-10;1;0;1;1.0;52841739
2023-04-10;1;2;3;0.0;52841740
2023-04-11;15;13;76;14.0;52841755
2023-04-11;0;3;2;-15.0;52841755
2023-04-11;0;0;6;0.0;52841755
2023-04-11;0;2;3;0.0;52841755
2023-04-11;3;2;7;3.0;52841758
2023-04-11;0;2;0;-3.0;52841758
2023-04-11;8;12;39;8.0;52841766
2023-04-11;5;5;12;-3.0;52841771
2023-04-11;2;2;1;-3.0;52841773
2023-04-11;2;2;5;0.0;52841775
2023-04-11;6;7;27;4.0;52841781
2023-04-11;7;7;23;1.0;52841788
2023-04-11;2;3;12;-5.0;52841790
2023-04-11;5;5;42;3.0;52841795
2023-04-11;55;65;255;50.0;52841850
2023-04-12;1;1;2;-54.0;52841851
2023-04-12;2;0;0;1.0;52841853
2023-04-12;54;62;177;52.0;52841907
2023-04-12;4;8;33;-50.0;52841911
2023-04-12;5;1;4;1.0;52841916
2023-04-12;10;6;34;5.0;52841926
2023-04-12;1;4;13;-9.0;52841927
2023-04-12;1;0;2;0.0;52841928
2023-04-12;1;3;3;0.0;52841929
2023-04-12;11;9;31;10.0;52841940
2023-04-12;1;0;0;-10.0;52841941
2023-04-12;7;8;12;6.0;52841948
2023-04-12;0;2;7;-7.0;52841948
2023-04-12;8;17;35;8.0;52841956
2023-04-12;2;3;1;-6.0;52841958
2023-04-13;1;1;6;-1.0;52841959
2023-04-13;2;2;5;1.0;52841961
2023-04-13;1;2;2;-1.0;52841962
2023-04-13;49;68;160;48.0;52842011
2023-04-13;12;13;24;-37.0;52842023
2023-04-13;1;1;2;-11.0;52842024
2023-04-13;8;9;19;7.0;52842032
2023-04-13;2;1;17;-6.0;52842034
2023-04-13;4;4;27;2.0;52842038
2023-04-13;0;0;1;-4.0;52842038
2023-04-13;4;9;17;4.0;52842042
2023-04-13;1;3;4;-3.0;52842043
2023-04-13;0;0;2;-1.0;52842043
2023-04-13;13;23;34;13.0;52842056
2023-04-13;0;0;0;-13.0;52842056
2023-04-14;0;0;0;0.0;52842056
2023-04-14;7;8;25;7.0;52842063
2023-04-14;2;1;0;-5.0;52842065
2023-04-14;20;24;50;18.0;52842085
2023-04-14;1;1;6;-19.0;52842086
2023-04-14;87;99;245;86.0;52842173
2023-04-14;5;1;4;-82.0;52842178
2023-04-14;16;18;37;11.0;52842194
2023-04-14;6;7;16;-10.0;52842200
2023-04-14;11;16;38;5.0;52842211
2023-04-14;0;3;1;-11.0;52842211
2023-04-14;3;4;11;3.0;52842214
2023-04-14;3;2;4;0.0;52842217
2023-04-14;11;11;42;8.0;52842228
2023-04-14;2;3;11;-9.0;52842230
2023-04-15;0;0;1;-2.0;52842230
2023-04-15;8;10;26;8.0;52842238
2023-04-15;0;0;0;-8.0;52842238
2023-04-15;3;10;23;3.0;52842241
2023-04-15;0;0;1;-3.0;52842241
2023-04-15;0;0;0;0.0;52842241
2023-04-15;1;0;0;1.0;52842242
2023-04-15;5;5;16;4.0;52842247
2023-04-15;26;40;115;21.0;52842273
2023-04-15;1;1;1;-25.0;52842274
2023-04-15;0;4;10;-1.0;52842274
2023-04-15;0;2;0;0.0;52842274
2023-04-15;0;0;3;0.0;52842274
2023-04-15;4;4;15;4.0;52842278
2023-04-15;4;4;19;0.0;52842282
2023-04-16;0;1;1;-4.0;52842282
2023-04-16;1;1;2;1.0;52842283
2023-04-16;1;1;0;0.0;52842284
2023-04-16;6;7;7;5.0;52842290
2023-04-16;0;1;2;-6.0;52842290
2023-04-16;0;0;0;0.0;52842290
2023-04-16;0;1;0;0.0;52842290
2023-04-16;0;0;0;0.0;52842290
2023-04-16;0;0;0;0.0;52842290
2023-04-16;1;1;2;1.0;52842291
2023-04-16;0;0;0;-1.0;52842291
2023-04-16;0;0;0;0.0;52842291
2023-04-16;3;1;0;3.0;52842294
2023-04-16;0;0;0;-3.0;52842294
2023-04-16;0;0;0;0.0;52842294
2023-04-17;12;17;39;12.0;52842306
2023-04-17;4;5;17;-8.0;52842310
2023-04-17;0;0;5;-4.0;52842310
2023-04-17;9;4;31;9.0;52842319
2023-04-17;0;0;0;-9.0;52842319
2023-04-17;2;8;9;2.0;52842321
2023-04-17;5;6;34;3.0;52842326
2023-04-17;0;2;0;-5.0;52842326
2023-04-17;2;0;5;2.0;52842328
2023-04-17;2;0;3;0.0;52842330
2023-04-17;3;2;1;1.0;52842333
2023-04-17;0;0;1;-3.0;52842333
2023-04-17;45;59;174;45.0;52842378
2023-04-17;0;4;5;-45.0;52842378
2023-04-17;6;11;24;6.0;52842384
2023-04-18;10;13;29;4.0;52842394
2023-04-18;5;0;8;-5.0;52842399
2023-04-18;10;4;14;5.0;52842409
2023-04-18;0;0;0;-10.0;52842409
2023-04-18;1;0;0;1.0;52842410
2023-04-18;3;3;4;2.0;52842413
2023-04-18;2;2;5;-1.0;52842415
2023-04-18;6;2;41;4.0;52842421
2023-04-18;59;53;182;53.0;52842480
2023-04-18;8;10;24;-51.0;52842488
2023-04-18;1;3;3;-7.0;52842489
2023-04-18;2;5;18;1.0;52842491
2023-04-18;9;8;31;7.0;52842500
2023-04-18;1;1;5;-8.0;52842501
2023-04-18;1;2;0;0.0;52842502
2023-04-19;2;0;3;1.0;52842504
2023-04-19;39;59;109;37.0;52842543
2023-04-19;1;2;6;-38.0;52842544
2023-04-19;0;0;2;-1.0;52842544
2023-04-19;2;0;3;2.0;52842546
2023-04-19;1;0;0;-1.0;52842547
2023-04-19;10;10;17;9.0;52842557
2023-04-19;2;1;8;-8.0;52842559
2023-04-19;4;4;15;2.0;52842563
2023-04-19;2;0;13;-2.0;52842565
2023-04-19;1;0;0;-1.0;52842566
2023-04-19;0;0;4;-1.0;52842566
2023-04-19;1;2;3;1.0;52842567
2023-04-19;8;32;14;7.0;52842575
2023-04-19;5;8;21;-3.0;52842580
2023-04-20;1;2;3;-4.0;52842581
2023-04-20;1;2;2;0.0;52842582
2023-04-20;3;6;14;2.0;52842585
2023-04-20;2;4;26;-1.0;52842587
2023-04-20;2;2;0;0.0;52842589
2023-04-20;0;0;1;-2.0;52842589
2023-04-20;0;1;4;0.0;52842589
2023-04-20;2;1;2;2.0;52842591
2023-04-20;45;49;132;43.0;52842636
2023-04-20;10;9;27;-35.0;52842646
2023-04-20;5;9;9;-5.0;52842651
2023-04-20;0;1;6;-5.0;52842651
2023-04-20;0;0;0;0.0;52842651
2023-04-20;10;8;20;10.0;52842661
2023-04-20;9;4;18;-1.0;52842670
2023-04-21;1;1;0;-8.0;52842671
2023-04-21;3;0;9;2.0;52842674
2023-04-21;6;6;43;3.0;52842680
2023-04-21;15;20;40;9.0;52842695
2023-04-21;1;2;4;-14.0;52842696
2023-04-21;1;1;2;0.0;52842697
2023-04-21;3;2;4;2.0;52842700
2023-04-21;61;80;238;58.0;52842761
2023-04-21;15;12;38;-46.0;52842776
2023-04-21;0;1;2;-15.0;52842776
2023-04-21;4;16;33;4.0;52842780
2023-04-21;2;2;6;-2.0;52842782
2023-04-21;0;2;1;-2.0;52842782
2023-04-21;5;8;34;5.0;52842787
2023-04-21;5;7;22;0.0;52842792
2023-04-22;1;0;1;-4.0;52842793
2023-04-22;7;8;15;6.0;52842800
2023-04-22;5;7;12;-2.0;52842805
2023-04-22;2;3;19;-3.0;52842807
2023-04-22;0;0;2;-2.0;52842807
2023-04-22;6;3;5;6.0;52842813
2023-04-22;7;5;15;1.0;52842820
2023-04-22;0;1;0;-7.0;52842820
2023-04-22;1;1;3;1.0;52842821
2023-04-22;0;2;1;-1.0;52842821
2023-04-22;33;36;86;33.0;52842854
2023-04-22;0;0;0;-33.0;52842854
2023-04-22;1;2;1;1.0;52842855
2023-04-22;3;2;12;2.0;52842858
2023-04-22;0;2;0;-3.0;52842858
2023-04-23;2;1;1;2.0;52842860
2023-04-23;1;2;1;-1.0;52842861
2023-04-23;0;0;1;-1.0;52842861
2023-04-23;0;0;1;0.0;52842861
2023-04-23;0;0;2;0.0;52842861
2023-04-23;0;0;0;0.0;52842861
2023-04-23;1;0;1;1.0;52842862
2023-04-23;0;0;0;-1.0;52842862
2023-04-23;5;4;7;5.0;52842867
2023-04-23;0;0;0;-5.0;52842867
2023-04-23;0;0;0;0.0;52842867
2023-04-23;0;0;0;0.0;52842867
2023-04-23;0;1;0;0.0;52842867
2023-04-23;0;0;0;0.0;52842867
2023-04-23;1;0;0;1.0;52842868
2023-04-24;0;0;0;-1.0;52842868
2023-04-24;1;3;17;1.0;52842869
2023-04-24;37;17;25;36.0;52842906
2023-04-24;1;1;0;-36.0;52842907
2023-04-24;4;10;30;3.0;52842911
2023-04-24;2;1;2;-2.0;52842913
2023-04-24;2;1;1;0.0;52842915
2023-04-24;1;3;6;-1.0;52842916
2023-04-24;1;2;3;0.0;52842917
2023-04-24;1;7;9;0.0;52842918
2023-04-24;0;1;0;-1.0;52842918
2023-04-24;1;0;2;1.0;52842919
2023-04-24;9;10;23;8.0;52842928
2023-04-24;1;2;5;-8.0;52842929
2023-04-24;61;58;123;60.0;52842990
2023-04-25;5;6;13;-56.0;52842995
2023-04-25;6;8;14;1.0;52843001
2023-04-25;2;1;7;-4.0;52843003
2023-04-25;1;2;4;-1.0;52843004
2023-04-25;1;0;3;0.0;52843005
2023-04-25;1;2;13;0.0;52843006
2023-04-25;14;9;31;13.0;52843020
2023-04-25;2;4;8;-12.0;52843022
2023-04-25;0;1;0;-2.0;52843022
2023-04-25;1;0;1;1.0;52843023
2023-04-25;0;1;1;-1.0;52843023
2023-04-25;1;1;1;1.0;52843024
2023-04-25;10;9;28;9.0;52843034
2023-04-25;54;49;164;44.0;52843088
2023-04-25;10;5;40;-44.0;52843098
2023-04-26;44;49;111;34.0;52843142
2023-04-26;12;10;13;-32.0;52843154
2023-04-26;5;4;3;-7.0;52843159
2023-04-26;0;1;0;-5.0;52843159
2023-04-26;8;4;9;8.0;52843167
2023-04-26;1;0;6;-7.0;52843168
2023-04-26;0;0;6;-1.0;52843168
2023-04-26;0;2;3;0.0;52843168
2023-04-26;0;2;0;0.0;52843168
2023-04-26;0;3;1;0.0;52843168
2023-04-26;5;9;26;5.0;52843173
2023-04-26;0;0;0;-5.0;52843173
2023-04-26;0;0;2;0.0;52843173
2023-04-26;4;7;22;4.0;52843177
2023-04-26;9;7;20;5.0;52843186
2023-04-27;7;4;19;-2.0;52843193
2023-04-27;50;51;141;43.0;52843243
2023-04-27;0;1;2;-50.0;52843243
2023-04-27;6;4;8;6.0;52843249
2023-04-27;8;12;25;2.0;52843257
2023-04-27;1;0;2;-7.0;52843258
2023-04-27;1;1;1;0.0;52843259
2023-04-27;1;0;0;0.0;52843260
2023-04-27;1;0;5;0.0;52843261
2023-04-27;1;1;12;0.0;52843262
2023-04-27;10;14;22;9.0;52843272
2023-04-27;6;4;26;-4.0;52843278
2023-04-27;0;0;0;-6.0;52843278
2023-04-27;0;2;6;0.0;52843278
2023-04-27;8;8;13;8.0;52843286
2023-04-28;0;1;2;-8.0;52843286
2023-04-28;0;1;0;0.0;52843286
2023-04-28;1;1;0;1.0;52843287
2023-04-28;9;6;20;8.0;52843296
2023-04-28;1;0;5;-8.0;52843297
2023-04-28;3;1;4;2.0;52843300
2023-04-28;9;5;18;6.0;52843309
2023-04-28;2;1;6;-7.0;52843311
2023-04-28;0;0;7;-2.0;52843311
2023-04-28;1;1;2;1.0;52843312
2023-04-28;14;9;17;13.0;52843326
2023-04-28;17;9;34;3.0;52843343
2023-04-28;90;67;194;73.0;52843433
2023-04-28;9;11;50;-81.0;52843442
2023-04-28;24;21;29;15.0;52843466
2023-04-29;3;6;6;-21.0;52843469
2023-04-29;1;1;0;-2.0;52843470
2023-04-29;38;39;68;37.0;52843508
2023-04-29;13;7;21;-25.0;52843521
2023-04-29;6;5;7;-7.0;52843527
2023-04-29;0;0;0;-6.0;52843527
2023-04-29;1;4;0;1.0;52843528
2023-04-29;1;0;1;0.0;52843529
2023-04-29;4;4;8;3.0;52843533
2023-04-29;0;1;2;-4.0;52843533
2023-04-29;5;5;13;5.0;52843538
2023-04-29;4;2;6;-1.0;52843542
2023-04-29;0;3;0;-4.0;52843542
2023-04-29;0;1;4;0.0;52843542
2023-04-29;0;0;0;0.0;52843542
2023-04-30;0;0;0;0.0;52843542
2023-04-30;0;0;0;0.0;52843542
2023-04-30;0;0;0;0.0;52843542
2023-04-30;0;0;0;0.0;52843542
2023-04-30;0;1;0;0.0;52843542
2023-04-30;1;2;2;1.0;52843543
2023-04-30;1;0;1;0.0;52843544
2023-04-30;0;0;0;-1.0;52843544
2023-04-30;1;0;1;1.0;52843545
2023-04-30;0;0;0;-1.0;52843545
2023-04-30;0;0;0;0.0;52843545
2023-04-30;0;0;0;0.0;52843545
2023-04-30;3;3;4;3.0;52843548
2023-04-30;0;0;0;-3.0;52843548
2023-04-30;0;0;0;0.0;52843548
2023-05-01;1;0;0;1.0;52843549
2023-05-01;2;5;9;1.0;52843551
2023-05-01;0;0;0;-2.0;52843551
2023-05-01;0;1;0;0.0;52843551
2023-05-01;0;0;2;0.0;52843551
2023-05-01;0;0;1;0.0;52843551
2023-05-01;0;0;0;0.0;52843551
2023-05-01;0;0;0;0.0;52843551
2023-05-01;1;2;1;1.0;52843552
2023-05-01;0;0;0;-1.0;52843552
2023-05-01;2;2;4;2.0;52843554
2023-05-01;0;0;5;-2.0;52843554
2023-05-01;0;0;0;0.0;52843554
2023-05-01;9;11;25;9.0;52843563
2023-05-01;3;1;3;-6.0;52843566
2023-05-02;10;9;26;7.0;52843576
2023-05-02;1;2;2;-9.0;52843577
2023-05-02;7;5;47;6.0;52843584
2023-05-02;3;2;5;-4.0;52843587
2023-05-02;103;79;218;100.0;52843690
2023-05-02;5;4;19;-98.0;52843695
2023-05-02;0;0;0;-5.0;52843695
2023-05-02;53;23;42;53.0;52843748
2023-05-02;0;0;2;-53.0;52843748
2023-05-02;5;15;37;5.0;52843753
2023-05-02;4;4;3;-1.0;52843757
2023-05-02;2;3;6;-2.0;52843759
2023-05-02;3;3;7;1.0;52843762
2023-05-02;10;8;21;7.0;52843772
2023-05-02;0;1;1;-10.0;52843772
2023-05-03;69;41;116;69.0;52843841
2023-05-03;4;5;7;-65.0;52843845
2023-05-03;1;0;0;-3.0;52843846
2023-05-03;12;9;24;11.0;52843858
2023-05-03;1;3;5;-11.0;52843859
2023-05-03;2;2;4;1.0;52843861
2023-05-03;5;3;8;3.0;52843866
2023-05-03;1;0;1;-4.0;52843867
2023-05-03;2;3;8;1.0;52843869
2023-05-03;1;1;6;-1.0;52843870
2023-05-03;28;7;19;27.0;52843898
2023-05-03;1;1;1;-27.0;52843899
2023-05-03;3;2;5;2.0;52843902
2023-05-03;7;5;23;4.0;52843909
2023-05-03;1;0;5;-6.0;52843910
2023-05-04;1;2;22;0.0;52843911
2023-05-04;0;0;0;-1.0;52843911
2023-05-04;7;10;37;7.0;52843918
2023-05-04;38;57;200;31.0;52843956
2023-05-04;2;0;7;-36.0;52843958
2023-05-04;3;4;32;1.0;52843961
2023-05-04;2;2;9;-1.0;52843963
2023-05-04;0;2;1;-2.0;52843963
2023-05-04;3;1;8;3.0;52843966
2023-05-04;0;0;0;-3.0;52843966
2023-05-04;7;20;31;7.0;52843973
2023-05-04;7;8;23;0.0;52843980
2023-05-04;2;1;4;-5.0;52843982
2023-05-04;0;4;8;-2.0;52843982
2023-05-04;4;3;18;4.0;52843986
2023-05-05;0;0;0;-4.0;52843986
2023-05-05;3;1;2;3.0;52843989
2023-05-05;5;5;9;2.0;52843994
2023-05-05;1;0;5;-4.0;52843995
2023-05-05;1;1;2;0.0;52843996
2023-05-05;3;1;9;2.0;52843999
2023-05-05;0;0;0;-3.0;52843999
2023-05-05;8;9;43;8.0;52844007
2023-05-05;2;4;9;-6.0;52844009
2023-05-05;8;3;19;6.0;52844017
2023-05-05;1;3;5;-7.0;52844018
2023-05-05;11;11;21;10.0;52844029
2023-05-05;6;12;28;-5.0;52844035
2023-05-05;0;0;1;-6.0;52844035
2023-05-05;49;50;153;49.0;52844084
2023-05-06;2;1;1;-47.0;52844086
2023-05-06;4;2;6;2.0;52844090
2023-05-06;8;6;13;4.0;52844098
2023-05-06;40;28;77;32.0;52844138
2023-05-06;2;1;0;-38.0;52844140
2023-05-06;6;5;21;4.0;52844146
2023-05-06;9;4;10;3.0;52844155
2023-05-06;2;3;9;-7.0;52844157
2023-05-06;4;4;12;2.0;52844161
2023-05-06;0;1;0;-4.0;52844161
2023-05-06;0;0;0;0.0;52844161
2023-05-06;1;0;0;1.0;52844162
2023-05-06;1;0;0;0.0;52844163
2023-05-06;0;1;0;-1.0;52844163
2023-05-06;1;0;5;1.0;52844164
2023-05-07;0;0;0;-1.0;52844164
2023-05-07;0;0;0;0.0;52844164
2023-05-07;0;0;0;0.0;52844164
2023-05-07;0;0;0;0.0;52844164
2023-05-07;0;1;0;0.0;52844164
2023-05-07;2;6;6;2.0;52844166
2023-05-07;0;1;0;-2.0;52844166
2023-05-07;0;0;1;0.0;52844166
2023-05-07;0;1;1;0.0;52844166
2023-05-07;0;0;0;0.0;52844166
2023-05-07;0;0;0;0.0;52844166
2023-05-07;0;1;3;0.0;52844166
2023-05-07;0;0;0;0.0;52844166
2023-05-07;2;1;1;2.0;52844168
2023-05-07;0;1;0;-2.0;52844168
2023-05-08;1;1;1;1.0;52844169
2023-05-08;0;0;0;-1.0;52844169
2023-05-08;1;1;0;1.0;52844170
2023-05-08;1;0;0;0.0;52844171
2023-05-08;0;0;0;-1.0;52844171
2023-05-08;0;0;0;0.0;52844171
2023-05-08;3;0;1;3.0;52844174
2023-05-08;1;0;0;-2.0;52844175
2023-05-08;2;2;1;1.0;52844177
2023-05-08;0;0;1;-2.0;52844177
2023-05-08;0;0;3;0.0;52844177
2023-05-08;0;1;1;0.0;52844177
2023-05-08;0;0;1;0.0;52844177
2023-05-08;11;5;9;11.0;52844188
2023-05-08;2;0;0;-9.0;52844190
2023-05-09;4;5;5;2.0;52844194
2023-05-09;0;0;0;-4.0;52844194
2023-05-09;37;43;101;37.0;52844231
2023-05-09;0;1;0;-37.0;52844231
2023-05-09;8;11;20;8.0;52844239
2023-05-09;0;1;0;-8.0;52844239
2023-05-09;4;2;9;4.0;52844243
2023-05-09;6;6;10;2.0;52844249
2023-05-09;1;1;5;-5.0;52844250
2023-05-09;2;1;8;1.0;52844252
2023-05-09;2;1;6;0.0;52844254
2023-05-09;4;11;22;2.0;52844258
2023-05-09;2;1;6;-2.0;52844260
2023-05-09;1;1;2;-1.0;52844261
2023-05-09;3;1;8;2.0;52844264
2023-05-10;4;8;15;1.0;52844268
2023-05-10;1;1;6;-3.0;52844269
2023-05-10;3;1;7;2.0;52844272
2023-05-10;2;1;4;-1.0;52844274
2023-05-10;15;4;13;13.0;52844289
2023-05-10;3;2;11;-12.0;52844292
2023-05-10;1;3;1;-2.0;52844293
2023-05-10;58;50;117;57.0;52844351
2023-05-10;1;4;0;-57.0;52844352
2023-05-10;7;2;7;6.0;52844359
2023-05-10;6;2;9;-1.0;52844365
2023-05-10;7;15;23;1.0;52844372
2023-05-10;6;2;13;-1.0;52844378
2023-05-10;1;4;8;-5.0;52844379
2023-05-10;1;1;0;0.0;52844380
2023-05-11;3;0;1;2.0;52844383
2023-05-11;3;2;8;0.0;52844386
2023-05-11;2;3;15;-1.0;52844388
2023-05-11;1;0;4;-1.0;52844389
2023-05-11;6;8;15;5.0;52844395
2023-05-11;41;31;92;35.0;52844436
2023-05-11;0;0;0;-41.0;52844436
2023-05-11;1;1;0;1.0;52844437
2023-05-11;2;0;3;1.0;52844439
2023-05-11;8;11;15;6.0;52844447
2023-05-11;4;3;12;-4.0;52844451
2023-05-11;1;2;4;-3.0;52844452
2023-05-11;2;0;2;1.0;52844454
2023-05-11;5;0;7;3.0;52844459
2023-05-11;3;1;6;-2.0;52844462
2023-05-12;4;12;19;1.0;52844466
2023-05-12;0;0;0;-4.0;52844466
2023-05-12;6;14;14;6.0;52844472
2023-05-12;2;1;6;-4.0;52844474
2023-05-12;1;3;2;-1.0;52844475
2023-05-12;8;4;24;7.0;52844483
2023-05-12;5;3;11;-3.0;52844488
2023-05-12;4;1;4;-1.0;52844492
2023-05-12;4;4;11;0.0;52844496
2023-05-12;1;3;7;-3.0;52844497
2023-05-12;2;1;5;1.0;52844499
2023-05-12;4;3;12;2.0;52844503
2023-05-12;43;49;116;39.0;52844546
2023-05-12;1;0;1;-42.0;52844547
2023-05-12;1;0;0;0.0;52844548
2023-05-13;0;0;0;-1.0;52844548
2023-05-13;5;2;1;5.0;52844553
2023-05-13;0;0;3;-5.0;52844553
2023-05-13;1;3;8;1.0;52844554
2023-05-13;3;3;11;2.0;52844557
2023-05-13;1;1;1;-2.0;52844558
2023-05-13;3;1;1;2.0;52844561
2023-05-13;0;0;2;-3.0;52844561
2023-05-13;27;28;60;27.0;52844588
2023-05-13;5;3;6;-22.0;52844593
2023-05-13;2;6;4;-3.0;52844595
2023-05-13;0;0;1;-2.0;52844595
2023-05-13;0;1;0;0.0;52844595
2023-05-13;5;4;11;5.0;52844600
2023-05-13;2;4;11;-3.0;52844602
2023-05-14;2;1;2;0.0;52844604
2023-05-14;0;0;0;-2.0;52844604
2023-05-14;0;0;0;0.0;52844604
2023-05-14;0;0;1;0.0;52844604
2023-05-14;0;0;0;0.0;52844604
2023-05-14;0;0;1;0.0;52844604
2023-05-14;1;0;0;1.0;52844605
2023-05-14;4;0;1;3.0;52844609
2023-05-14;0;1;0;-4.0;52844609
2023-05-14;0;0;0;0.0;52844609
2023-05-14;0;0;0;0.0;52844609
2023-05-14;1;0;1;1.0;52844610
2023-05-14;8;3;6;7.0;52844618
2023-05-14;0;0;0;-8.0;52844618
2023-05-14;0;1;0;0.0;52844618
2023-05-15;3;0;13;3.0;52844621
2023-05-15;8;5;10;5.0;52844629
2023-05-15;0;0;8;-8.0;52844629
2023-05-15;1;2;3;1.0;52844630
2023-05-15;5;0;6;4.0;52844635
2023-05-15;27;24;79;22.0;52844662
2023-05-15;0;0;0;-27.0;52844662
2023-05-15;1;1;1;1.0;52844663
2023-05-15;1;4;2;0.0;52844664
2023-05-15;1;2;3;0.0;52844665
2023-05-15;1;3;10;0.0;52844666
2023-05-15;0;0;0;-1.0;52844666
2023-05-15;6;6;19;6.0;52844672
2023-05-15;0;1;4;-6.0;52844672
2023-05-15;0;0;0;0.0;52844672
2023-05-16;1;0;1;1.0;52844673
2023-05-16;2;4;17;1.0;52844675
2023-05-16;0;0;0;-2.0;52844675
2023-05-16;3;7;12;3.0;52844678
2023-05-16;3;6;9;0.0;52844681
2023-05-16;4;5;9;1.0;52844685
2023-05-16;1;1;3;-3.0;52844686
2023-05-16;2;2;6;1.0;52844688
2023-05-16;33;44;95;31.0;52844721
2023-05-16;10;16;13;-23.0;52844731
2023-05-16;0;1;6;-10.0;52844731
2023-05-16;0;0;0;0.0;52844731
2023-05-16;2;1;8;2.0;52844733
2023-05-16;5;1;9;3.0;52844738
2023-05-16;0;0;2;-5.0;52844738
2023-05-17;0;0;3;0.0;52844738
2023-05-17;2;2;3;2.0;52844740
2023-05-17;10;28;15;8.0;52844750
2023-05-17;2;1;8;-8.0;52844752
2023-05-17;2;0;4;0.0;52844754
2023-05-17;11;7;13;9.0;52844765
2023-05-17;0;1;0;-11.0;52844765
2023-05-17;0;0;0;0.0;52844765
2023-05-17;5;2;7;5.0;52844770
2023-05-17;3;4;6;-2.0;52844773
2023-05-17;0;2;6;-3.0;52844773
2023-05-17;0;0;6;0.0;52844773
2023-05-17;5;2;8;5.0;52844778
2023-05-17;45;54;89;40.0;52844823
2023-05-17;5;5;10;-40.0;52844828
2023-05-18;0;0;0;-5.0;52844828
2023-05-18;0;0;0;0.0;52844828
2023-05-18;0;0;0;0.0;52844828
2023-05-18;0;1;0;0.0;52844828
2023-05-18;0;1;1;0.0;52844828
2023-05-18;0;1;0;0.0;52844828
2023-05-18;0;0;0;0.0;52844828
2023-05-18;0;0;0;0.0;52844828
2023-05-18;0;0;0;0.0;52844828
2023-05-18;1;0;1;1.0;52844829
2023-05-18;0;0;0;-1.0;52844829
2023-05-18;1;1;2;1.0;52844830
2023-05-18;0;0;0;-1.0;52844830
2023-05-18;0;0;0;0.0;52844830
2023-05-18;2;4;4;2.0;52844832
2023-05-19;2;2;5;0.0;52844834
2023-05-19;3;3;13;1.0;52844837
2023-05-19;8;10;16;5.0;52844845
2023-05-19;3;1;0;-5.0;52844848
2023-05-19;0;3;0;-3.0;52844848
2023-05-19;0;0;2;0.0;52844848
2023-05-19;0;1;2;0.0;52844848
2023-05-19;1;2;12;1.0;52844849
2023-05-19;4;2;9;3.0;52844853
2023-05-19;34;45;112;30.0;52844887
2023-05-19;2;2;23;-32.0;52844889
2023-05-19;9;17;25;7.0;52844898
2023-05-19;0;0;0;-9.0;52844898
2023-05-19;1;2;1;1.0;52844899
2023-05-19;1;0;4;0.0;52844900
2023-05-20;3;2;6;2.0;52844903
2023-05-20;3;4;11;0.0;52844906
2023-05-20;21;19;41;18.0;52844927
2023-05-20;0;0;0;-21.0;52844927
2023-05-20;1;1;0;1.0;52844928
2023-05-20;1;0;0;0.0;52844929
2023-05-20;2;1;3;1.0;52844931
2023-05-20;4;0;0;2.0;52844935
2023-05-20;0;0;0;-4.0;52844935
2023-05-20;1;1;3;1.0;52844936
2023-05-20;2;0;1;1.0;52844938
2023-05-20;0;0;5;-2.0;52844938
2023-05-20;1;3;8;1.0;52844939
2023-05-20;1;7;4;0.0;52844940
2023-05-20;2;0;0;1.0;52844942
2023-05-21;0;0;0;-2.0;52844942
2023-05-21;0;0;0;0.0;52844942
2023-05-21;0;0;1;0.0;52844942
2023-05-21;0;0;0;0.0;52844942
2023-05-21;0;0;0;0.0;52844942
2023-05-21;1;3;0;1.0;52844943
2023-05-21;8;4;4;7.0;52844951
2023-05-21;0;0;0;-8.0;52844951
2023-05-21;0;0;1;0.0;52844951
2023-05-21;0;1;0;0.0;52844951
2023-05-21;2;0;0;2.0;52844953
2023-05-21;0;0;1;-2.0;52844953
2023-05-21;0;0;0;0.0;52844953
2023-05-21;1;0;0;1.0;52844954
2023-05-21;4;0;1;3.0;52844958
2023-05-22;3;3;7;-1.0;52844961
2023-05-22;2;1;18;-1.0;52844963
2023-05-22;5;0;9;3.0;52844968
2023-05-22;0;0;5;-5.0;52844968
2023-05-22;0;0;0;0.0;52844968
2023-05-22;2;4;8;2.0;52844970
2023-05-22;0;0;0;-2.0;52844970
2023-05-22;1;0;6;1.0;52844971
2023-05-22;1;2;1;0.0;52844972
2023-05-22;5;2;6;4.0;52844977
2023-05-22;1;0;4;-4.0;52844978
2023-05-22;29;5;14;28.0;52845007
2023-05-22;0;0;6;-29.0;52845007
2023-05-22;0;1;0;0.0;52845007
2023-05-22;49;18;84;49.0;52845056
2023-05-23;1;0;7;-48.0;52845057
2023-05-23;5;7;13;4.0;52845062
2023-05-23;4;2;11;-1.0;52845066
2023-05-23;1;0;1;-3.0;52845067
2023-05-23;2;5;12;1.0;52845069
2023-05-23;1;2;3;-1.0;52845070
2023-05-23;29;29;84;28.0;52845099
2023-05-23;2;4;9;-27.0;52845101
2023-05-23;1;2;3;-1.0;52845102
2023-05-23;1;2;6;0.0;52845103
2023-05-23;3;2;4;2.0;52845106
2023-05-23;8;1;11;5.0;52845114
2023-05-23;0;1;0;-8.0;52845114
2023-05-23;0;1;4;0.0;52845114
2023-05-23;0;0;0;0.0;52845114
2023-05-24;3;2;0;3.0;52845117
2023-05-24;1;1;1;-2.0;52845118
2023-05-24;1;1;1;0.0;52845119
2023-05-24;6;6;9;5.0;52845125
2023-05-24;1;0;2;-5.0;52845126
2023-05-24;4;6;10;3.0;52845130
2023-05-24;5;1;7;1.0;52845135
2023-05-24;0;0;0;-5.0;52845135
2023-05-24;2;1;5;2.0;52845137
2023-05-24;2;1;7;0.0;52845139
2023-05-24;34;31;79;32.0;52845173
2023-05-24;3;2;9;-31.0;52845176
2023-05-24;2;1;7;-1.0;52845178
2023-05-24;2;7;16;0.0;52845180
2023-05-24;2;2;5;0.0;52845182
2023-05-25;1;3;4;-1.0;52845183
2023-05-25;2;4;2;1.0;52845185
2023-05-25;3;2;11;1.0;52845188
2023-05-25;1;0;6;-2.0;52845189
2023-05-25;7;7;8;6.0;52845196
2023-05-25;3;3;11;-4.0;52845199
2023-05-25;0;0;0;-3.0;52845199
2023-05-25;32;33;80;32.0;52845231
2023-05-25;4;4;8;-28.0;52845235
2023-05-25;3;4;11;-1.0;52845238
2023-05-25;4;3;11;1.0;52845242
2023-05-25;0;1;0;-4.0;52845242
2023-05-25;0;0;0;0.0;52845242
2023-05-25;4;1;4;4.0;52845246
2023-05-25;0;1;4;-4.0;52845246
2023-05-26;6;13;15;6.0;52845252
2023-05-26;2;9;14;-4.0;52845254
2023-05-26;3;2;3;1.0;52845257
2023-05-26;6;3;9;3.0;52845263
2023-05-26;1;0;0;-5.0;52845264
2023-05-26;43;48;112;42.0;52845307
2023-05-26;1;1;7;-42.0;52845308
2023-05-26;0;0;4;-1.0;52845308
2023-05-26;4;2;3;4.0;52845312
2023-05-26;1;1;5;-3.0;52845313
2023-05-26;4;5;21;3.0;52845317
2023-05-26;3;1;1;-1.0;52845320
2023-05-26;0;0;0;-3.0;52845320
2023-05-26;3;4;11;3.0;52845323
2023-05-26;9;7;19;6.0;52845332
2023-05-27;3;5;2;-6.0;52845335
2023-05-27;1;1;3;-2.0;52845336
2023-05-27;4;1;5;3.0;52845340
2023-05-27;3;3;7;-1.0;52845343
2023-05-27;3;2;4;0.0;52845346
2023-05-27;0;0;0;-3.0;52845346
2023-05-27;0;1;1;0.0;52845346
2023-05-27;2;0;1;2.0;52845348
2023-05-27;0;0;2;-2.0;52845348
2023-05-27;19;18;37;19.0;52845367
2023-05-27;0;0;1;-19.0;52845367
2023-05-27;2;2;11;2.0;52845369
2023-05-27;0;2;0;-2.0;52845369
2023-05-27;0;0;0;0.0;52845369
2023-05-27;1;1;0;1.0;52845370
2023-05-28;1;3;2;0.0;52845371
2023-05-28;0;0;0;-1.0;52845371
2023-05-28;0;0;0;0.0;52845371
2023-05-28;0;0;0;0.0;52845371
2023-05-28;0;1;0;0.0;52845371
2023-05-28;0;0;0;0.0;52845371
2023-05-28;0;0;0;0.0;52845371
2023-05-28;0;0;0;0.0;52845371
2023-05-28;0;0;0;0.0;52845371
2023-05-28;0;0;1;0.0;52845371
2023-05-28;1;1;1;1.0;52845372
2023-05-28;0;0;0;-1.0;52845372
2023-05-28;0;0;0;0.0;52845372
2023-05-28;0;0;0;0.0;52845372
2023-05-28;0;1;0;0.0;52845372
2023-05-29;2;0;1;2.0;52845374
2023-05-29;0;0;0;-2.0;52845374
2023-05-29;0;0;0;0.0;52845374
2023-05-29;0;0;0;0.0;52845374
2023-05-29;0;0;1;0.0;52845374
2023-05-29;4;1;4;4.0;52845378
2023-05-29;0;0;0;-4.0;52845378
2023-05-29;0;0;0;0.0;52845378
2023-05-29;0;0;0;0.0;52845378
2023-05-29;0;0;1;0.0;52845378
2023-05-29;0;0;0;0.0;52845378
2023-05-29;0;0;1;0.0;52845378
2023-05-29;2;1;0;2.0;52845380
2023-05-29;0;0;0;-2.0;52845380
2023-05-29;0;0;0;0.0;52845380
2023-05-30;0;0;8;0.0;52845380
2023-05-30;0;1;1;0.0;52845380
2023-05-30;4;2;8;4.0;52845384
2023-05-30;7;6;13;3.0;52845391
2023-05-30;2;1;10;-5.0;52845393
2023-05-30;5;6;9;3.0;52845398
2023-05-30;21;3;11;16.0;52845419
2023-05-30;2;0;9;-19.0;52845421
2023-05-30;7;1;1;5.0;52845428
2023-05-30;0;0;0;-7.0;52845428
2023-05-30;2;0;2;2.0;52845430
2023-05-30;56;23;86;54.0;52845486
2023-05-30;2;1;7;-54.0;52845488
2023-05-30;0;0;0;-2.0;52845488
2023-05-30;4;2;7;4.0;52845492
2023-05-31;6;9;6;2.0;52845498
2023-05-31;3;1;8;-3.0;52845501
2023-05-31;1;1;7;-2.0;52845502
2023-05-31;1;1;0;0.0;52845503
2023-05-31;0;2;0;-1.0;52845503
2023-05-31;0;2;0;0.0;52845503
2023-05-31;1;4;10;1.0;52845504
2023-05-31;3;7;8;2.0;52845507
2023-05-31;2;3;7;-1.0;52845509
2023-05-31;1;5;6;-1.0;52845510
2023-05-31;1;4;1;0.0;52845511
2023-05-31;8;5;3;7.0;52845519
2023-05-31;31;44;63;23.0;52845550
2023-05-31;3;0;5;-28.0;52845553
2023-05-31;1;0;2;-2.0;52845554
2023-06-01;2;7;12;1.0;52845556
2023-06-01;1;2;7;-1.0;52845557
2023-06-01;2;3;1;1.0;52845559
2023-06-01;0;0;0;-2.0;52845559
2023-06-01;1;1;4;1.0;52845560
2023-06-01;1;1;5;0.0;52845561
2023-06-01;14;4;19;13.0;52845575
2023-06-01;1;0;0;-13.0;52845576
2023-06-01;3;4;6;2.0;52845579
2023-06-01;7;0;8;4.0;52845586
2023-06-01;37;31;81;30.0;52845623
2023-06-01;1;1;1;-36.0;52845624
2023-06-01;0;0;0;-1.0;52845624
2023-06-01;3;5;12;3.0;52845627
2023-06-01;1;3;6;-2.0;52845628
2023-06-02;0;1;0;-1.0;52845628
2023-06-02;0;0;1;0.0;52845628
2023-06-02;2;1;6;2.0;52845630
2023-06-02;32;40;103;30.0;52845662
2023-06-02;1;0;5;-31.0;52845663
2023-06-02;2;2;2;1.0;52845665
2023-06-02;6;7;13;4.0;52845671
2023-06-02;1;4;15;-5.0;52845672
2023-06-02;3;3;13;2.0;52845675
2023-06-02;2;3;7;-1.0;52845677
2023-06-02;4;7;10;2.0;52845681
2023-06-02;3;3;12;-1.0;52845684
2023-06-02;3;3;6;0.0;52845687
2023-06-02;5;6;13;2.0;52845692
2023-06-02;0;0;0;-5.0;52845692
2023-06-03;2;4;10;2.0;52845694
2023-06-03;0;1;1;-2.0;52845694
2023-06-03;0;0;0;0.0;52845694
2023-06-03;2;4;4;2.0;52845696
2023-06-03;0;2;4;-2.0;52845696
2023-06-03;0;0;0;0.0;52845696
2023-06-03;1;0;0;1.0;52845697
2023-06-03;0;0;0;-1.0;52845697
2023-06-03;14;18;32;14.0;52845711
2023-06-03;1;2;1;-13.0;52845712
2023-06-03;2;0;1;1.0;52845714
2023-06-03;2;1;3;0.0;52845716
2023-06-03;1;3;4;-1.0;52845717
2023-06-03;0;0;0;-1.0;52845717
2023-06-03;3;1;4;3.0;52845720
2023-06-04;0;0;0;-3.0;52845720
2023-06-04;0;0;0;0.0;52845720
2023-06-04;0;0;0;0.0;52845720
2023-06-04;0;8;3;0.0;52845720
2023-06-04;0;0;0;0.0;52845720
2023-06-04;0;0;1;0.0;52845720
2023-06-04;0;0;0;0.0;52845720
2023-06-04;0;0;0;0.0;52845720
2023-06-04;0;1;1;0.0;52845720
2023-06-04;0;1;0;0.0;52845720
2023-06-04;0;2;0;0.0;52845720
2023-06-04;0;3;1;0.0;52845720
2023-06-04;0;1;0;0.0;52845720
2023-06-04;0;0;0;0.0;52845720
2023-06-04;0;0;0;0.0;52845720
2023-06-05;0;0;1;0.0;52845720
2023-06-05;2;3;4;2.0;52845722
2023-06-05;0;6;8;-2.0;52845722
2023-06-05;4;1;4;4.0;52845726
2023-06-05;61;32;60;57.0;52845787
2023-06-05;38;6;10;-23.0;52845825
2023-06-05;1;0;1;-37.0;52845826
2023-06-05;3;1;3;2.0;52845829
2023-06-05;3;1;2;0.0;52845832
2023-06-05;1;6;4;-2.0;52845833
2023-06-05;2;1;0;1.0;52845835
2023-06-05;0;1;0;-2.0;52845835
2023-06-05;4;2;8;4.0;52845839
2023-06-05;3;2;5;-1.0;52845842
2023-06-05;0;2;10;-3.0;52845842
2023-06-06;2;5;9;2.0;52845844
2023-06-06;2;1;4;0.0;52845846
2023-06-06;2;1;0;0.0;52845848
2023-06-06;2;2;7;0.0;52845850
2023-06-06;4;3;7;2.0;52845854
2023-06-06;5;11;7;1.0;52845859
2023-06-06;3;3;10;-2.0;52845862
2023-06-06;0;0;0;-3.0;52845862
2023-06-06;4;2;15;4.0;52845866
2023-06-06;2;4;4;-2.0;52845868
2023-06-06;0;0;0;-2.0;52845868
2023-06-06;15;11;11;15.0;52845883
2023-06-06;47;50;100;32.0;52845930
2023-06-06;4;6;20;-43.0;52845934
2023-06-06;2;1;6;-2.0;52845936
2023-06-07;3;0;0;1.0;52845939
2023-06-07;1;2;5;-2.0;52845940
2023-06-07;1;5;8;0.0;52845941
2023-06-07;0;0;5;-1.0;52845941
2023-06-07;2;0;0;2.0;52845943
2023-06-07;1;0;3;-1.0;52845944
2023-06-07;2;4;4;1.0;52845946
2023-06-07;1;3;6;-1.0;52845947
2023-06-07;7;5;8;6.0;52845954
2023-06-07;1;0;3;-6.0;52845955
2023-06-07;1;3;12;0.0;52845956
2023-06-07;1;0;1;0.0;52845957
2023-06-07;1;0;4;0.0;52845958
2023-06-07;6;2;11;5.0;52845964
2023-06-07;28;24;70;22.0;52845992
2023-06-08;2;0;5;-26.0;52845994
2023-06-08;1;0;5;-1.0;52845995
2023-06-08;1;2;3;0.0;52845996
2023-06-08;2;0;0;1.0;52845998
2023-06-08;4;3;9;2.0;52846002
2023-06-08;3;2;6;-1.0;52846005
2023-06-08;3;2;8;0.0;52846008
2023-06-08;39;33;84;36.0;52846047
2023-06-08;5;9;9;-34.0;52846052
2023-06-08;1;1;0;-4.0;52846053
2023-06-08;5;6;9;4.0;52846058
2023-06-08;2;1;4;-3.0;52846060
2023-06-08;1;1;5;-1.0;52846061
2023-06-08;1;2;1;0.0;52846062
2023-06-08;8;4;20;7.0;52846070
2023-06-09;6;4;6;-2.0;52846076
2023-06-09;0;0;1;-6.0;52846076
2023-06-09;33;63;91;33.0;52846109
2023-06-09;2;3;8;-31.0;52846111
2023-06-09;3;0;5;1.0;52846114
2023-06-09;0;1;1;-3.0;52846114
2023-06-09;4;7;12;4.0;52846118
2023-06-09;2;2;5;-2.0;52846120
2023-06-09;0;0;3;-2.0;52846120
2023-06-09;3;9;13;3.0;52846123
2023-06-09;0;0;0;-3.0;52846123
2023-06-09;8;25;16;8.0;52846131
2023-06-09;1;3;6;-7.0;52846132
2023-06-09;0;5;10;-1.0;52846132
2023-06-09;4;4;5;4.0;52846136
2023-06-10;5;3;1;1.0;52846141
2023-06-10;0;1;4;-5.0;52846141
2023-06-10;0;4;7;0.0;52846141
2023-06-10;0;0;0;0.0;52846141
2023-06-10;1;1;0;1.0;52846142
2023-06-10;0;0;2;-1.0;52846142
2023-06-10;14;19;30;14.0;52846156
2023-06-10;0;0;1;-14.0;52846156
2023-06-10;0;1;0;0.0;52846156
2023-06-10;2;2;6;2.0;52846158
2023-06-10;2;0;3;0.0;52846160
2023-06-10;1;2;0;-1.0;52846161
2023-06-10;3;5;5;2.0;52846164
2023-06-10;0;0;0;-3.0;52846164
2023-06-10;0;0;1;0.0;52846164
2023-06-11;0;0;0;0.0;52846164
2023-06-11;0;1;1;0.0;52846164
2023-06-11;1;2;2;1.0;52846165
2023-06-11;0;0;0;-1.0;52846165
2023-06-11;0;0;1;0.0;52846165
2023-06-11;0;1;0;0.0;52846165
2023-06-11;0;0;0;0.0;52846165
2023-06-11;0;0;0;0.0;52846165
2023-06-11;0;0;0;0.0;52846165
2023-06-11;0;0;0;0.0;52846165
2023-06-11;0;0;0;0.0;52846165
2023-06-11;1;0;0;1.0;52846166
2023-06-11;0;0;0;-1.0;52846166
2023-06-11;0;0;0;0.0;52846166
2023-06-11;0;0;0;0.0;52846166
2023-06-12;5;1;11;5.0;52846171
2023-06-12;0;1;5;-5.0;52846171
2023-06-12;0;1;0;0.0;52846171
2023-06-12;2;5;7;2.0;52846173
2023-06-12;0;1;4;-2.0;52846173
2023-06-12;21;33;69;21.0;52846194
2023-06-12;2;2;4;-19.0;52846196
2023-06-12;0;1;1;-2.0;52846196
2023-06-12;1;2;6;1.0;52846197
2023-06-12;2;0;2;1.0;52846199
2023-06-12;0;1;6;-2.0;52846199
2023-06-12;3;1;14;3.0;52846202
2023-06-12;0;0;0;-3.0;52846202
2023-06-12;4;17;5;4.0;52846206
2023-06-12;2;0;4;-2.0;52846208
2023-06-13;1;2;6;-1.0;52846209
2023-06-13;19;23;83;18.0;52846228
2023-06-13;0;0;2;-19.0;52846228
2023-06-13;0;0;0;0.0;52846228
2023-06-13;1;0;0;1.0;52846229
2023-06-13;2;1;7;1.0;52846231
2023-06-13;1;5;7;-1.0;52846232
2023-06-13;0;0;0;-1.0;52846232
2023-06-13;0;1;1;0.0;52846232
2023-06-13;3;2;11;3.0;52846235
2023-06-13;1;0;7;-2.0;52846236
2023-06-13;1;0;7;0.0;52846237
2023-06-13;3;2;12;2.0;52846240
2023-06-13;4;5;12;1.0;52846244
2023-06-13;2;5;11;-2.0;52846246
2023-06-14;0;2;0;-2.0;52846246
2023-06-14;16;52;72;16.0;52846262
2023-06-14;0;2;6;-16.0;52846262
2023-06-14;1;2;8;1.0;52846263
2023-06-14;3;4;9;2.0;52846266
2023-06-14;3;0;3;0.0;52846269
2023-06-14;0;0;0;-3.0;52846269
2023-06-14;0;1;6;0.0;52846269
2023-06-14;5;25;17;5.0;52846274
2023-06-14;1;6;2;-4.0;52846275
2023-06-14;1;1;3;0.0;52846276
2023-06-14;1;2;8;0.0;52846277
2023-06-14;0;3;5;-1.0;52846277
2023-06-14;0;0;0;0.0;52846277
2023-06-14;1;4;5;1.0;52846278
2023-06-15;2;4;6;1.0;52846280
2023-06-15;0;2;7;-2.0;52846280
2023-06-15;3;4;5;3.0;52846283
2023-06-15;8;5;21;5.0;52846291
2023-06-15;0;2;8;-8.0;52846291
2023-06-15;1;2;5;1.0;52846292
2023-06-15;2;1;10;1.0;52846294
2023-06-15;3;7;6;1.0;52846297
2023-06-15;0;0;1;-3.0;52846297
2023-06-15;0;0;5;0.0;52846297
2023-06-15;0;1;0;0.0;52846297
2023-06-15;4;0;3;4.0;52846301
2023-06-15;1;1;0;-3.0;52846302
2023-06-15;1;2;3;0.0;52846303
2023-06-15;25;31;80;24.0;52846328
2023-06-16;1;1;1;-24.0;52846329
2023-06-16;3;5;6;2.0;52846332
2023-06-16;1;0;0;-2.0;52846333
2023-06-16;11;9;15;10.0;52846344
2023-06-16;33;47;63;22.0;52846377
2023-06-16;4;4;7;-29.0;52846381
2023-06-16;0;0;1;-4.0;52846381
2023-06-16;2;3;3;2.0;52846383
2023-06-16;0;0;0;-2.0;52846383
2023-06-16;2;7;4;2.0;52846385
2023-06-16;2;6;2;0.0;52846387
2023-06-16;2;2;5;0.0;52846389
2023-06-16;2;5;12;0.0;52846391
2023-06-16;0;0;0;-2.0;52846391
2023-06-16;3;5;7;3.0;52846394
2023-06-17;0;0;2;-3.0;52846394
2023-06-17;0;3;3;0.0;52846394
2023-06-17;0;0;0;0.0;52846394
2023-06-17;2;3;2;2.0;52846396
2023-06-17;0;1;0;-2.0;52846396
2023-06-17;9;24;27;9.0;52846405
2023-06-17;3;5;8;-6.0;52846408
2023-06-17;0;0;0;-3.0;52846408
2023-06-17;0;0;0;0.0;52846408
2023-06-17;0;0;0;0.0;52846408
2023-06-17;0;0;0;0.0;52846408
2023-06-17;0;1;3;0.0;52846408
2023-06-17;3;3;5;3.0;52846411
2023-06-17;1;4;0;-2.0;52846412
2023-06-17;0;4;4;-1.0;52846412
2023-06-18;0;0;1;0.0;52846412
2023-06-18;0;0;1;0.0;52846412
2023-06-18;1;1;0;1.0;52846413
2023-06-18;2;3;5;1.0;52846415
2023-06-18;0;0;0;-2.0;52846415
2023-06-18;0;0;0;0.0;52846415
2023-06-18;0;0;0;0.0;52846415
2023-06-18;0;0;0;0.0;52846415
2023-06-18;0;0;0;0.0;52846415
2023-06-18;0;0;0;0.0;52846415
2023-06-18;1;0;0;1.0;52846416
2023-06-18;0;0;0;-1.0;52846416
2023-06-18;0;2;0;0.0;52846416
2023-06-18;0;0;3;0.0;52846416
2023-06-18;0;0;0;0.0;52846416
2023-06-19;1;1;1;1.0;52846417
2023-06-19;1;2;3;0.0;52846418
2023-06-19;0;0;0;-1.0;52846418
2023-06-19;1;1;3;1.0;52846419
2023-06-19;2;0;4;1.0;52846421
2023-06-19;13;3;6;11.0;52846434
2023-06-19;1;4;7;-12.0;52846435
2023-06-19;2;1;2;1.0;52846437
2023-06-19;0;0;1;-2.0;52846437
2023-06-19;3;1;13;3.0;52846440
2023-06-19;1;0;0;-2.0;52846441
2023-06-19;3;1;6;2.0;52846444
2023-06-19;36;19;57;33.0;52846480
2023-06-19;2;2;3;-34.0;52846482
2023-06-19;6;3;8;4.0;52846488
2023-06-20;3;2;4;-3.0;52846491
2023-06-20;2;0;0;-1.0;52846493
2023-06-20;0;0;0;-2.0;52846493
2023-06-20;0;1;0;0.0;52846493
2023-06-20;1;0;1;1.0;52846494
2023-06-20;13;5;12;12.0;52846507
2023-06-20;1;1;2;-12.0;52846508
2023-06-20;1;1;4;0.0;52846509
2023-06-20;1;1;2;0.0;52846510
2023-06-20;3;0;5;2.0;52846513
2023-06-20;4;0;11;1.0;52846517
2023-06-20;40;21;79;36.0;52846557
2023-06-20;3;4;6;-37.0;52846560
2023-06-20;3;3;19;0.0;52846563
2023-06-20;5;3;13;2.0;52846568
2023-06-21;1;3;6;-4.0;52846569
2023-06-21;1;3;6;0.0;52846570
2023-06-21;0;0;5;-1.0;52846570
2023-06-21;1;2;5;1.0;52846571
2023-06-21;1;3;21;0.0;52846572
2023-06-21;1;3;3;0.0;52846573
2023-06-21;1;2;10;0.0;52846574
2023-06-21;1;2;2;0.0;52846575
2023-06-21;0;0;1;-1.0;52846575
2023-06-21;0;0;8;0.0;52846575
2023-06-21;11;24;77;11.0;52846586
2023-06-21;1;1;1;-10.0;52846587
2023-06-21;0;2;0;-1.0;52846587
2023-06-21;3;3;9;3.0;52846590
2023-06-21;0;0;0;-3.0;52846590
2023-06-22;0;0;1;0.0;52846590
2023-06-22;24;14;85;24.0;52846614
2023-06-22;2;0;2;-22.0;52846616
2023-06-22;2;0;6;0.0;52846618
2023-06-22;5;1;16;3.0;52846623
2023-06-22;3;1;6;-2.0;52846626
2023-06-22;0;0;0;-3.0;52846626
2023-06-22;1;1;4;1.0;52846627
2023-06-22;0;0;0;-1.0;52846627
2023-06-22;0;1;3;0.0;52846627
2023-06-22;2;1;12;2.0;52846629
2023-06-22;0;0;5;-2.0;52846629
2023-06-22;1;1;8;1.0;52846630
2023-06-22;8;7;13;7.0;52846638
2023-06-22;0;1;9;-8.0;52846638
2023-06-23;0;1;5;0.0;52846638
2023-06-23;0;0;0;0.0;52846638
2023-06-23;4;1;3;4.0;52846642
2023-06-23;4;7;8;0.0;52846646
2023-06-23;3;3;8;-1.0;52846649
2023-06-23;1;0;4;-2.0;52846650
2023-06-23;6;3;19;5.0;52846656
2023-06-23;3;3;2;-3.0;52846659
2023-06-23;7;3;7;4.0;52846666
2023-06-23;0;0;0;-7.0;52846666
2023-06-23;4;0;2;4.0;52846670
2023-06-23;5;2;6;1.0;52846675
2023-06-23;1;0;0;-4.0;52846676
2023-06-23;38;27;66;37.0;52846714
2023-06-23;0;4;2;-38.0;52846714
2023-06-24;1;0;2;1.0;52846715
2023-06-24;0;0;2;-1.0;52846715
2023-06-24;0;0;2;0.0;52846715
2023-06-24;1;1;3;1.0;52846716
2023-06-24;0;0;0;-1.0;52846716
2023-06-24;0;0;1;0.0;52846716
2023-06-24;1;0;2;1.0;52846717
2023-06-24;0;0;0;-1.0;52846717
2023-06-24;0;0;0;0.0;52846717
2023-06-24;5;5;24;5.0;52846722
2023-06-24;0;0;3;-5.0;52846722
2023-06-24;2;2;6;2.0;52846724
2023-06-24;0;0;2;-2.0;52846724
2023-06-24;0;0;0;0.0;52846724
2023-06-24;0;2;1;0.0;52846724
2023-06-25;0;0;1;0.0;52846724
2023-06-25;0;0;3;0.0;52846724
2023-06-25;0;0;1;0.0;52846724
2023-06-25;0;0;0;0.0;52846724
2023-06-25;0;0;0;0.0;52846724
2023-06-25;0;0;0;0.0;52846724
2023-06-25;1;0;0;1.0;52846725
2023-06-25;0;0;0;-1.0;52846725
2023-06-25;0;0;0;0.0;52846725
2023-06-25;1;0;5;1.0;52846726
2023-06-25;0;0;0;-1.0;52846726
2023-06-25;0;0;0;0.0;52846726
2023-06-25;0;0;0;0.0;52846726
2023-06-25;0;0;0;0.0;52846726
2023-06-25;0;0;0;0.0;52846726
2023-06-26;2;0;0;2.0;52846728
2023-06-26;1;0;1;-1.0;52846729
2023-06-26;11;6;9;10.0;52846740
2023-06-26;0;0;5;-11.0;52846740
2023-06-26;1;0;1;1.0;52846741
2023-06-26;1;0;5;0.0;52846742
2023-06-26;1;0;6;0.0;52846743
2023-06-26;2;0;1;1.0;52846745
2023-06-26;0;1;0;-2.0;52846745
2023-06-26;23;12;59;23.0;52846768
2023-06-26;0;3;5;-23.0;52846768
2023-06-26;0;0;10;0.0;52846768
2023-06-26;2;0;11;2.0;52846770
2023-06-26;0;0;0;-2.0;52846770
2023-06-26;2;2;5;2.0;52846772
2023-06-27;5;4;3;3.0;52846777
2023-06-27;0;0;0;-5.0;52846777
2023-06-27;2;0;3;2.0;52846779
2023-06-27;1;1;18;-1.0;52846780
2023-06-27;29;15;61;28.0;52846809
2023-06-27;1;3;8;-28.0;52846810
2023-06-27;2;2;2;1.0;52846812
2023-06-27;1;0;6;-1.0;52846813
2023-06-27;1;1;2;0.0;52846814
2023-06-27;4;1;5;3.0;52846818
2023-06-27;2;0;0;-2.0;52846820
2023-06-27;6;0;7;4.0;52846826
2023-06-27;0;0;0;-6.0;52846826
2023-06-27;1;1;2;1.0;52846827
2023-06-27;3;2;5;2.0;52846830
2023-06-28;1;2;11;-2.0;52846831
2023-06-28;0;0;0;-1.0;52846831
2023-06-28;4;9;7;4.0;52846835
2023-06-28;2;0;0;-2.0;52846837
2023-06-28;1;2;1;-1.0;52846838
2023-06-28;1;0;2;0.0;52846839
2023-06-28;1;3;0;0.0;52846840
2023-06-28;0;2;2;-1.0;52846840
2023-06-28;4;2;4;4.0;52846844
2023-06-28;0;1;0;-4.0;52846844
2023-06-28;1;2;2;1.0;52846845
2023-06-28;1;0;5;0.0;52846846
2023-06-28;3;1;3;2.0;52846849
2023-06-28;0;0;4;-3.0;52846849
2023-06-28;19;24;41;19.0;52846868
2023-06-29;1;0;3;-18.0;52846869
2023-06-29;0;0;0;-1.0;52846869
2023-06-29;1;3;13;1.0;52846870
2023-06-29;0;3;4;-1.0;52846870
2023-06-29;0;0;8;0.0;52846870
2023-06-29;3;2;6;3.0;52846873
2023-06-29;0;0;0;-3.0;52846873
2023-06-29;19;16;57;19.0;52846892
2023-06-29;0;0;3;-19.0;52846892
2023-06-29;1;0;3;1.0;52846893
2023-06-29;4;3;8;3.0;52846897
2023-06-29;2;1;3;-2.0;52846899
2023-06-29;1;1;2;-1.0;52846900
2023-06-29;0;0;1;-1.0;52846900
2023-06-29;6;3;3;6.0;52846906
2023-06-30;21;28;61;15.0;52846927
2023-06-30;4;4;5;-17.0;52846931
2023-06-30;1;5;16;-3.0;52846932
2023-06-30;3;3;11;2.0;52846935
2023-06-30;2;0;8;-1.0;52846937
2023-06-30;0;1;2;-2.0;52846937
2023-06-30;0;0;3;0.0;52846937
2023-06-30;0;1;1;0.0;52846937
2023-06-30;0;0;0;0.0;52846937
2023-06-30;3;3;6;3.0;52846940
2023-06-30;4;2;3;1.0;52846944
2023-06-30;0;1;1;-4.0;52846944
2023-06-30;1;0;1;1.0;52846945
2023-06-30;1;2;1;0.0;52846946
2023-06-30;2;6;3;1.0;52846948
2023-07-01;1;2;3;-1.0;52846949
2023-07-01;3;3;7;2.0;52846952
2023-07-01;2;1;0;-1.0;52846954
2023-07-01;1;0;1;-1.0;52846955
2023-07-01;0;0;0;-1.0;52846955
2023-07-01;2;1;0;2.0;52846957
2023-07-01;3;3;1;1.0;52846960
2023-07-01;1;0;0;-2.0;52846961
2023-07-01;5;4;4;4.0;52846966
2023-07-01;0;2;2;-5.0;52846966
2023-07-01;0;0;0;0.0;52846966
2023-07-01;20;20;21;20.0;52846986
2023-07-01;0;1;1;-20.0;52846986
2023-07-01;1;3;1;1.0;52846987
2023-07-01;1;0;1;0.0;52846988
2023-07-02;0;0;0;-1.0;52846988
2023-07-02;0;0;0;0.0;52846988
2023-07-02;0;0;0;0.0;52846988
2023-07-02;0;0;1;0.0;52846988
2023-07-02;0;0;0;0.0;52846988
2023-07-02;0;0;0;0.0;52846988
2023-07-02;0;0;0;0.0;52846988
2023-07-02;0;0;0;0.0;52846988
2023-07-02;0;0;0;0.0;52846988
2023-07-02;0;0;0;0.0;52846988
2023-07-02;0;0;0;0.0;52846988
2023-07-02;0;0;0;0.0;52846988
2023-07-02;0;0;0;0.0;52846988
2023-07-02;0;0;0;0.0;52846988
2023-07-02;0;0;1;0.0;52846988
2023-07-03;0;0;0;0.0;52846988
2023-07-03;4;3;4;4.0;52846992
2023-07-03;1;0;6;-3.0;52846993
2023-07-03;0;0;2;-1.0;52846993
2023-07-03;3;1;6;3.0;52846996
2023-07-03;0;0;0;-3.0;52846996
2023-07-03;6;3;10;6.0;52847002
2023-07-03;38;13;44;32.0;52847040
2023-07-03;0;0;0;-38.0;52847040
2023-07-03;2;1;2;2.0;52847042
2023-07-03;18;3;4;16.0;52847060
2023-07-03;1;0;1;-17.0;52847061
2023-07-03;3;1;7;2.0;52847064
2023-07-03;0;1;2;-3.0;52847064
2023-07-03;0;0;0;0.0;52847064
2023-07-04;2;1;2;2.0;52847066
2023-07-04;1;1;5;-1.0;52847067
2023-07-04;15;15;58;14.0;52847082
2023-07-04;1;0;4;-14.0;52847083
2023-07-04;0;1;0;-1.0;52847083
2023-07-04;0;2;6;0.0;52847083
2023-07-04;0;0;3;0.0;52847083
2023-07-04;2;0;5;2.0;52847085
2023-07-04;1;0;3;-1.0;52847086
2023-07-04;2;4;4;1.0;52847088
2023-07-04;1;0;5;-1.0;52847089
2023-07-04;0;1;5;-1.0;52847089
2023-07-04;0;0;0;0.0;52847089
2023-07-04;0;1;0;0.0;52847089
2023-07-04;5;4;16;5.0;52847094
2023-07-05;2;0;6;-3.0;52847096
2023-07-05;0;0;0;-2.0;52847096
2023-07-05;2;2;3;2.0;52847098
2023-07-05;3;3;4;1.0;52847101
2023-07-05;0;0;4;-3.0;52847101
2023-07-05;0;0;0;0.0;52847101
2023-07-05;1;1;3;1.0;52847102
2023-07-05;0;1;0;-1.0;52847102
2023-07-05;21;9;45;21.0;52847123
2023-07-05;4;0;3;-17.0;52847127
2023-07-05;1;1;2;-3.0;52847128
2023-07-05;0;0;3;-1.0;52847128
2023-07-05;2;1;4;2.0;52847130
2023-07-05;3;0;3;1.0;52847133
2023-07-05;3;0;10;0.0;52847136
2023-07-06;3;5;6;0.0;52847139
2023-07-06;2;0;5;-1.0;52847141
2023-07-06;0;0;7;-2.0;52847141
2023-07-06;0;0;0;0.0;52847141
2023-07-06;1;1;6;1.0;52847142
2023-07-06;9;4;8;8.0;52847151
2023-07-06;0;0;0;-9.0;52847151
2023-07-06;2;2;12;2.0;52847153
2023-07-06;1;1;1;-1.0;52847154
2023-07-06;0;0;2;-1.0;52847154
2023-07-06;1;0;0;1.0;52847155
2023-07-06;21;13;54;20.0;52847176
2023-07-06;0;0;4;-21.0;52847176
2023-07-06;0;0;1;0.0;52847176
2023-07-06;2;0;2;2.0;52847178
2023-07-07;3;1;3;1.0;52847181
2023-07-07;2;1;6;-1.0;52847183
2023-07-07;0;0;0;-2.0;52847183
2023-07-07;4;3;13;4.0;52847187
2023-07-07;28;28;70;24.0;52847215
2023-07-07;0;0;0;-28.0;52847215
2023-07-07;2;3;8;2.0;52847217
2023-07-07;1;0;2;-1.0;52847218
2023-07-07;1;2;7;0.0;52847219
2023-07-07;0;0;2;-1.0;52847219
2023-07-07;1;0;4;1.0;52847220
2023-07-07;0;2;0;-1.0;52847220
2023-07-07;3;3;4;3.0;52847223
2023-07-07;10;10;18;7.0;52847233
2023-07-07;1;3;3;-9.0;52847234
2023-07-08;6;8;29;5.0;52847240
2023-07-08;0;1;4;-6.0;52847240
2023-07-08;2;0;11;2.0;52847242
2023-07-08;0;0;0;-2.0;52847242
2023-07-08;0;1;0;0.0;52847242
2023-07-08;0;0;0;0.0;52847242
2023-07-08;0;0;2;0.0;52847242
2023-07-08;1;0;0;1.0;52847243
2023-07-08;0;2;4;-1.0;52847243
2023-07-08;0;0;0;0.0;52847243
2023-07-08;0;1;1;0.0;52847243
2023-07-08;0;0;0;0.0;52847243
2023-07-08;0;0;1;0.0;52847243
2023-07-08;0;2;0;0.0;52847243
2023-07-08;3;1;6;3.0;52847246
2023-07-09;0;0;0;-3.0;52847246
2023-07-09;0;0;0;0.0;52847246
2023-07-09;0;0;0;0.0;52847246
2023-07-09;0;0;0;0.0;52847246
2023-07-09;0;0;0;0.0;52847246
2023-07-09;0;0;0;0.0;52847246
2023-07-09;0;0;0;0.0;52847246
2023-07-09;1;1;0;1.0;52847247
2023-07-09;0;0;0;-1.0;52847247
2023-07-09;0;0;0;0.0;52847247
2023-07-09;0;0;0;0.0;52847247
2023-07-09;0;1;0;0.0;52847247
2023-07-09;1;2;0;1.0;52847248
2023-07-09;0;0;0;-1.0;52847248
2023-07-09;0;0;0;0.0;52847248
2023-07-10;0;0;0;0.0;52847248
2023-07-10;0;2;6;0.0;52847248
2023-07-10;1;0;3;1.0;52847249
2023-07-10;2;3;2;1.0;52847251
2023-07-10;1;0;1;-1.0;52847252
2023-07-10;1;6;5;0.0;52847253
2023-07-10;1;0;3;0.0;52847254
2023-07-10;0;0;3;-1.0;52847254
2023-07-10;2;3;12;2.0;52847256
2023-07-10;0;0;4;-2.0;52847256
2023-07-10;0;2;0;0.0;52847256
2023-07-10;0;0;0;0.0;52847256
2023-07-10;0;0;0;0.0;52847256
2023-07-10;0;0;2;0.0;52847256
2023-07-10;8;16;41;8.0;52847264
